CGCTAAAATGC -> GCTAAAATGCT
GTGGAGAAGCT -> TGGAGAAGCTT
GCCGTGTGAGT -> CCGTGTGAGTG
CTCAGAGAATA -> TCAGAGAATAG
CTACTCGGCCA -> TACTCGGCCAA
CGGAAGATACC -> GGAAGATACCG
GTGGTTAACCC -> TGGTTAACCCC
GCATTCCGTTA -> CATTCCGTTAC
TGATGAGCTAA -> GATGAGCTAAC
GGGCTTAGCAA -> GGCTTAGCAAC
GGCTGTTAACC -> GCTGTTAACCT
TTTGGCTTCAG -> TTGGCTTCAGG
TTTTAAGTAGT -> TTTAAGTAGTG
TGCATTCCGTT -> GCATTCCGTTA
CGCGACGATCT -> GCGACGATCTA
TGGGGTTTTGG -> GGGGTTTTGGC
TTATGTAAGGG -> TATGTAAGGGT
AATCCCCCTGT -> ATCCCCCTGTC
TCCCCATTCCA -> CCCCATTCCAC
CTCCTGTTGGG -> TCCTGTTGGGG
GGAGGTCTTGG -> GAGGTCTTGGC
AGTATCAATTG -> GTATCAATTGA
CGCGGCTAACG -> GCGGCTAACGT
GAAGCTTTATG -> AAGCTTTATGC
GGAGGAGTTGA -> GAGGAGTTGAA
TGATCTGTTTT -> GATCTGTTTTC
AGAATAATCTA -> GAATAATCTAT
AATCTCCAAGG -> ATCTCCAAGGT
CAAAGAGTGTA -> AAAGAGTGTAC
CCTCTGGTAGA -> CTCTGGTAGAT
CATTCACCACA -> ATTCACCACAG
ATTCCGGCGGG -> TTCCGGCGGGG
AAAGGCTCATT -> AAGGCTCATTA
CTCCGTCTTCT -> TCCGTCTTCTC
ACAGGAGGGAG -> CAGGAGGGAGA
GACATCAGACA -> ACATCAGACAG
GCTGTATATAG -> CTGTATATAGG
TAGCTTAGACT -> AGCTTAGACTG
GCCGGGGATAC -> CCGGGGATACG
ATGATCTGTTA -> TGATCTGTTAT
GCCAAGCCCTG -> CCAAGCCCTGT
CGATTCGATCT -> GATTCGATCTG
GATGGGTATTC -> ATGGGTATTCC
GTAACAGTCGG -> TAACAGTCGGA
CACTGGATATG -> ACTGGATATGT
AGGGTTCCTGG -> GGGTTCCTGGT
ATGATTCTCGG -> TGATTCTCGGG
CGAGACGCGTT -> GAGACGCGTTC
ATGGTGGATGG -> TGGTGGATGGA
TGTCTGATGAT -> GTCTGATGATA
TTACACAAAGA -> TACACAAAGAG
CTAAAATGCTC -> TAAAATGCTCT
AGTGTTTCGAG -> GTGTTTCGAGA
CTAACCCGGCG -> TAACCCGGCGT
TGTCTTGATTA -> GTCTTGATTAT
TTATAGCTCCT -> TATAGCTCCTA
ATTATCGTGTC -> TTATCGTGTCG
GGCCGGGGATA -> GCCGGGGATAC
TACCTCTGGTA -> ACCTCTGGTAG
CTGTGAGGTGC -> TGTGAGGTGCA
GATCTCGCGAC -> ATCTCGCGACG
ATAATCTATGG -> TAATCTATGGA
CCAGAAAAGAT -> CAGAAAAGATG
ATTCGCCTACC -> TTCGCCTACCG
GTTAGAGACCG -> TTAGAGACCGA
ACGATCTATCG -> CGATCTATCGT
AAATTGGATGA -> AATTGGATGAT
CCATAATCTCC -> CATAATCTCCA
TGTGACCTGAA -> GTGACCTGAAT
TAAACTTGAAT -> AAACTTGAATT
CTACGATTGCA -> TACGATTGCAG
AACCTAGCTTA -> ACCTAGCTTAG
CTTTCTCTAAA -> TTTCTCTAAAT
ACAATCCCCCT -> CAATCCCCCTG
CCGACCCCTGA -> CGACCCCTGAC
AACTTTATTAT -> ACTTTATTATT
GAATAGGACCC -> AATAGGACCCT
TCTGATGATAC -> CTGATGATACC
CATTATCGTGT -> ATTATCGTGTC
TCTTTGGCTCC -> CTTTGGCTCCG
TCACATATGTT -> CACATATGTTG
AGAAACCTGCC -> GAAACCTGCCC
GTGTGACCTGA -> TGTGACCTGAA
TATTACACCCT -> ATTACACCCTG
TCTGTTTTCAA -> CTGTTTTCAAG
CTTTAGCCGTT -> TTTAGCCGTTA
TAGTAGTCCGG -> AGTAGTCCGGC
CGCCTGGTTCA -> GCCTGGTTCAC
AAAGACCATAT -> AAGACCATATT
AAATTGAGAAT -> AATTGAGAATA
GGTGCCTTCTC -> GTGCCTTCTCT
CTCCATTGTCT -> TCCATTGTCTG
GAGGACGTCAG -> AGGACGTCAGC
CGCCTATTTAT -> GCCTATTTATT
ACGCGTGTCGA -> CGCGTGTCGAA
CCTGGTTCACT -> CTGGTTCACTA
TATCGTGTCGG -> ATCGTGTCGGT
CAAGTAATGTC -> AAGTAATGTCT
TATTCTTTAGG -> ATTCTTTAGGG
TTCACGAAAGA -> TCACGAAAGAC
GGGGATTTGCG -> GGGATTTGCGA
GCTAACGTGTG -> CTAACGTGTGG
AATATCGCCTA -> ATATCGCCTAT
GTAACAGAGAT -> TAACAGAGATG
GGCATAAAATT -> GCATAAAATTG
AGTAGTCCGGC -> GTAGTCCGGCT
TCCACACTAGA -> CCACACTAGAG
GTAACAGAGAA -> TAACAGAGAAG
TACCGTTATTC -> ACCGTTATTCC
GCCATTTATTA -> CCATTTATTAT
TTATGATTTGT -> TATGATTTGTA
GACAAACGCGT -> ACAAACGCGTC
TAGTTGGTGGC -> AGTTGGTGGCG
GTCTCAGAGAA -> TCTCAGAGAAT
GCAGAGCATCT -> CAGAGCATCTC
GGTCTATAAAC -> GTCTATAAACT
GCGGCTAACGT -> CGGCTAACGTG
GACAATCCCCC -> ACAATCCCCCT
GATTCTCGGGG -> ATTCTCGGGGT
TCCGTCTTCTC -> CCGTCTTCTCC
CTTTAAGATGG -> TTTAAGATGGT
ATGGAGGTGGC -> TGGAGGTGGCC
GACCGAACGTA -> ACCGAACGTAC
GGGGGATTCGG -> GGGGATTCGGG
CCCGACCCCTG -> CCGACCCCTGA
GGAGAGGGCTT -> GAGAGGGCTTA
CCGGCGGGGGA -> CGGCGGGGGAT
TATCCTGTAGG -> ATCCTGTAGGC
CCCTGTCTGAT -> CCTGTCTGATG
TCCGTTCTATC -> CCGTTCTATCC
ACAGTTTTAGC -> CAGTTTTAGCG
GTCGATACAGT -> TCGATACAGTT
CCATATTCGCC -> CATATTCGCCT
TTACGCCCGGG -> TACGCCCGGGT
GTTATGGTCTG -> TTATGGTCTGA
CCGTGTCTTCA -> CGTGTCTTCAT
GAACTTTATTA -> AACTTTATTAT
AAACGACTTGC -> AACGACTTGCT
TTCTTTCTCTA -> TCTTTCTCTAA
CTGTATCACCC -> TGTATCACCCG
TTGGCTCCGTC -> TGGCTCCGTCT
AGAGGCATTCC -> GAGGCATTCCA
GGAGAGTTAGT -> GAGAGTTAGTT
ATGATTTGTAA -> TGATTTGTAAT
CTAAGCGTGAT -> TAAGCGTGATG
GAGAAGCTTTA -> AGAAGCTTTAT
TGGATCTCGCG -> GGATCTCGCGA
ACTGCGCGGCT -> CTGCGCGGCTA
CTGTAGGCCGT -> TGTAGGCCGTG
CCACTCGTGAG -> CACTCGTGAGT
GATTCGGGTGT -> ATTCGGGTGTG
TTCTCAATAGG -> TCTCAATAGGG
GTCGGACGCGC -> TCGGACGCGCA
TAAATTGGATG -> AAATTGGATGA
ACAGTTACTCT -> CAGTTACTCTA
CGGACGCGCAC -> GGACGCGCACA
TTGCTACGATT -> TGCTACGATTG
CTAGAGCAAAC -> TAGAGCAAACG
CGATGCATTCT -> GATGCATTCTC
CATGATCTGTT -> ATGATCTGTTA
TGCTTTGACCT -> GCTTTGACCTT
GTCTGATACTA -> TCTGATACTAC
TCCACTCGTGA -> CCACTCGTGAG
TAACAGAGAAG -> AACAGAGAAGT
GCCTTTCAGAA -> CCTTTCAGAAG
GCTCCGTCTTC -> CTCCGTCTTCT
CTCAAGATGAA -> TCAAGATGAAG
TTCGGAGGAGT -> TCGGAGGAGTT
ACCCTGGCTAT -> CCCTGGCTATG
CACCCTGGCTA -> ACCCTGGCTAT
CTGTTAACCTA -> TGTTAACCTAG
GCCGCTCGTTC -> CCGCTCGTTCT
TAGAGACCGAA -> AGAGACCGAAC
GACTCCGCATA -> ACTCCGCATAA
TAATCGGAATT -> AATCGGAATTT
GCAGAAACCTG -> CAGAAACCTGC
AGGCATTCCAT -> GGCATTCCATA
CTCTAAATTGG -> TCTAAATTGGA
GAGGGGGATTT -> AGGGGGATTTG
TTCTAGAAAAT -> TCTAGAAAATC
GATCGCGATTC -> ATCGCGATTCT
TGTGAGGTGCA -> GTGAGGTGCAG
AGGTGTGACCT -> GGTGTGACCTG
GGCGGGGGATG -> GCGGGGGATGT
AAGTAATGTCT -> AGTAATGTCTT
ACGCCCGGGTG -> CGCCCGGGTGG
CATTCCATAGG -> ATTCCATAGGT
TTCGAGACGCG -> TCGAGACGCGT
GTCTGGGAACT -> TCTGGGAACTT
TGGTAGTGGGT -> GGTAGTGGGTG
CACTCAAGATG -> ACTCAAGATGA
CGTATGGAATA -> GTATGGAATAG
ACATCACATAT -> CATCACATATG
CTCTAGCGCGG -> TCTAGCGCGGT
TTTCTACTGGA -> TTCTACTGGAT
GACATGATCGC -> ACATGATCGCG
GCCAGAAAAGA -> CCAGAAAAGAT
TGGAATAGGAC -> GGAATAGGACC
CAGTCAAGCTA -> AGTCAAGCTAC
CATGTTGGGCA -> ATGTTGGGCAA
CGCTTCATTTC -> GCTTCATTTCT
ATATGTTATGT -> TATGTTATGTA
GCCCCTGAGTC -> CCCCTGAGTCT
TTCTGCGGCGA -> TCTGCGGCGAC
ACGATTGCAGC -> CGATTGCAGCG
TATTGTCTGAC -> ATTGTCTGACG
GGGAGAATTTA -> GGAGAATTTAT
CACGAAAGACC -> ACGAAAGACCA
TAGGTAGGTCT -> AGGTAGGTCTC
TGCCCCTGAGT -> GCCCCTGAGTC
AAAGAGTGTAC -> AAGAGTGTACA
GCGCGCTAAAA -> CGCGCTAAAAT
CGGTGACATGA -> GGTGACATGAT
CACAAAGAGTG -> ACAAAGAGTGT
TACATTCACGA -> ACATTCACGAA
GGAGACAATCC -> GAGACAATCCC
TTCACCACAGG -> TCACCACAGGA
TCAGCGTGATT -> CAGCGTGATTT
TGGTGGTAGTG -> GGTGGTAGTGG
CTCTAGCGTAT -> TCTAGCGTATG
TCGCCTACCGT -> CGCCTACCGTG
GGCGGGTGCCT -> GCGGGTGCCTT
CGTCCAAGTGT -> GTCCAAGTGTT
GATGGGTCTAA -> ATGGGTCTAAG
CCATTGTCTGA -> CATTGTCTGAT
TTGAACCCATG -> TGAACCCATGG
AGTGTTGCTTA -> GTGTTGCTTAT
TATTCCTGGTC -> ATTCCTGGTCG
GCTCCATTGTC -> CTCCATTGTCT
GGGTGGGCGAT -> GGTGGGCGATT
CTGGTTCACTA -> TGGTTCACTAG
TAATTTTGATG -> AATTTTGATGG
TATAGCTCCTA -> ATAGCTCCTAC
GGCTTGCAAGG -> GCTTGCAAGGC
AGTCCGGCTGT -> GTCCGGCTGTT
AATAACCATGG -> ATAACCATGGT
GTATGGAATAG -> TATGGAATAGG
AACCTGCCCCT -> ACCTGCCCCTG
AGAGTGTACAT -> GAGTGTACATC
TGGTTAACCCC -> GGTTAACCCCG
TTCGGGTGTGA -> TCGGGTGTGAG
ATGTCTTTAGC -> TGTCTTTAGCC
GGTACTGTATC -> GTACTGTATCA
TCAACGCGTGT -> CAACGCGTGTC
GGCGTTACGCC -> GCGTTACGCCC
ACTGGATGGGC -> CTGGATGGGCC
TGTGGGACGCT -> GTGGGACGCTG
ATGTTGGGCAA -> TGTTGGGCAAC
TATGAGTGGGG -> ATGAGTGGGGG
CACACTAGAGG -> ACACTAGAGGC
TATGCGAGGTG -> ATGCGAGGTGG
GTTCTCGTCTA -> TTCTCGTCTAG
CGCGATTCTAA -> GCGATTCTAAC
TCTAAGCGTGA -> CTAAGCGTGAT
TTTTGGCTTCA -> TTTGGCTTCAG
TCTAGAAAATC -> CTAGAAAATCC
TTAACTTTTGC -> TAACTTTTGCA
GAAAGGTAAGC -> AAAGGTAAGCA
ATGCTCTTTGT -> TGCTCTTTGTT
AGCGTAACAGT -> GCGTAACAGTC
TGCCTTCTCTT -> GCCTTCTCTTG
TACTCTAGCGC -> ACTCTAGCGCG
TGGTGGATGGA -> GGTGGATGGAC
GTGTGAGTGTT -> TGTGAGTGTTT
AGTCGGACGCG -> GTCGGACGCGC
GCAACTAATCA -> CAACTAATCAG
TACTCGGCCAA -> ACTCGGCCAAG
TAAAATTGAGA -> AAAATTGAGAA
GATGCATTCTC -> ATGCATTCTCA
CTGTTGGGGTT -> TGTTGGGGTTT
TAGCCGTTATG -> AGCCGTTATGT
ACGCTGGACAT -> CGCTGGACATA
TCTAACCCGGC -> CTAACCCGGCG
ATAGGTACTGT -> TAGGTACTGTA
ATAAAATTGAG -> TAAAATTGAGA
ACCGTTGGAGG -> CCGTTGGAGGA
GGTGCAGCAGA -> GTGCAGCAGAG
GGATGGGCCAA -> GATGGGCCAAG
CAGCCTTTCAG -> AGCCTTTCAGA
TCGTGTCGGTG -> CGTGTCGGTGA
AGGGGGATTTG -> GGGGGATTTGC
CGTGATGAGCT -> GTGATGAGCTA
ACTAGAGCAAA -> CTAGAGCAAAC
ATCTATGGAGG -> TCTATGGAGGT
GTGGGCGATTC -> TGGGCGATTCT
CTTACACAAAG -> TTACACAAAGA
GGTTTGCGCGC -> GTTTGCGCGCT
TTTTGATGGGT -> TTTGATGGGTA
ACGGGGGAGCA -> CGGGGGAGCAC
TGATTTGTAAT -> GATTTGTAATC
CATCAGACAGT -> ATCAGACAGTT
GACGCGCACAC -> ACGCGCACACG
GGGAGGTCTTG -> GGAGGTCTTGG
ACAAACGCGTC -> CAAACGCGTCT
TCGGATGGGGT -> CGGATGGGGTT
CATATTCGCCT -> ATATTCGCCTA
GTAATCGCCTG -> TAATCGCCTGG
GACTTATGATT -> ACTTATGATTT
TTCTCTAAATT -> TCTCTAAATTG
CGCGGTTTCAA -> GCGGTTTCAAC
ACAGGAGGGGG -> CAGGAGGGGGA
AAAACGATTCG -> AAACGATTCGA
GACCCCTGACC -> ACCCCTGACCA
TTATTGTCTGA -> TATTGTCTGAC
CCGAACGTACA -> CGAACGTACAT
CCTGTCTGATG -> CTGTCTGATGA
GCGATGCATTC -> CGATGCATTCT
TATGGCGGGGC -> ATGGCGGGGCA
CCGACTTATGA -> CGACTTATGAT
TGGGCCGCTCG -> GGGCCGCTCGT
GCAAACGACTT -> CAAACGACTTG
GTATCACCCGA -> TATCACCCGAC
GATACCGTTAT -> ATACCGTTATT
GGCATTCCATA -> GCATTCCATAG
GCCAAGAACAT -> CCAAGAACATT
TCAGAGAATAG -> CAGAGAATAGA
TGGGAGAATTT -> GGGAGAATTTA
GATCTGTTATT -> ATCTGTTATTG
TTTAAGACATC -> TTAAGACATCA
ACTCGGCCAAG -> CTCGGCCAAGA
CGACACATTCA -> GACACATTCAC
ACCGAACGTAC -> CCGAACGTACA
TCTCTAAATTG -> CTCTAAATTGG
TTAAGACATCA -> TAAGACATCAG
GCATCTCTAGC -> CATCTCTAGCG
TGTAATCGGAA -> GTAATCGGAAT
ACGACTTGCTA -> CGACTTGCTAC
ATCACCTCTCG -> TCACCTCTCGA
ATCAGCGCTTA -> TCAGCGCTTAA
TGATGGGTATT -> GATGGGTATTC
GAGTCTATGCC -> AGTCTATGCCA
AGTTCTTACAC -> GTTCTTACACA
GGTGACATGAT -> GTGACATGATC
ATGGATCTCGC -> TGGATCTCGCG
TAGAAAATCCC -> AGAAAATCCCC
TCGGACGCGCA -> CGGACGCGCAC
TCCGGCGGGGG -> CCGGCGGGGGA
AGCTAACAAAC -> GCTAACAAACC
TGCTACGATTG -> GCTACGATTGC
TGTCTGACGGG -> GTCTGACGGGG
GTATCAATTGA -> TATCAATTGAA
CTAAATTGGAT -> TAAATTGGATG
GAATAGAACTG -> AATAGAACTGA
AACGACTTGCT -> ACGACTTGCTA
TTTATTACACC -> TTATTACACCC
TGCGTGGAGAA -> GCGTGGAGAAG
TACTGTATCAC -> ACTGTATCACC
ACATATGTTGT -> CATATGTTGTC
ACAGCTCCATT -> CAGCTCCATTG
TCTGTGGGCCG -> CTGTGGGCCGC
ATCAGACAGTT -> TCAGACAGTTA
CGAAAGACCAT -> GAAAGACCATA
TATATAGGTAG -> ATATAGGTAGG
CAAGAACATTA -> AAGAACATTAA
GCTTTATGCGG -> CTTTATGCGGT
GATAAGTGCCA -> ATAAGTGCCAT
TCATGATCTGT -> CATGATCTGTT
AATAGGACCCT -> ATAGGACCCTT
GTGACATGATC -> TGACATGATCG
ACGGTCTATAA -> CGGTCTATAAA
TTCATGATCTG -> TCATGATCTGT
CAAGTGTTGCT -> AAGTGTTGCTT
CCTGGTCGTAA -> CTGGTCGTAAA
ATCGCCTGGTT -> TCGCCTGGTTC
CTAATCAGCGC -> TAATCAGCGCT
ATATAGGTAGG -> TATAGGTAGGT
TGAGGTGCAGC -> GAGGTGCAGCA
AGTAATGTCTT -> GTAATGTCTTT
CTACCGTTGGA -> TACCGTTGGAG
TCCCCCTGTCT -> CCCCCTGTCTG
GGCGGGGCATA -> GCGGGGCATAA
TGTCGCAGAAA -> GTCGCAGAAAC
AAACCGGGAGA -> AACCGGGAGAC
CTTCTCTTGCC -> TTCTCTTGCCA
CAGCGTAATCG -> AGCGTAATCGC
GGCAGCCCATG -> GCAGCCCATGT
ATTCCGTTACT -> TTCCGTTACTG
TCAAGCTACGC -> CAAGCTACGCA
AAAATGCTCTT -> AAATGCTCTTT
CACCCCATTAG -> ACCCCATTAGT
CTCGGCCAAGA -> TCGGCCAAGAA
CAATAGGGTTC -> AATAGGGTTCC
ACAGAGATGGT -> CAGAGATGGTG
GGGATTCGGGT -> GGATTCGGGTG
GGGGAGCACAG -> GGGAGCACAGG
TTCACTCAAGA -> TCACTCAAGAT
TGAGTGCGTGG -> GAGTGCGTGGA
ATCTATCGTGG -> TCTATCGTGGT
CCGGCAGCCCA -> CGGCAGCCCAT
GGTCGATACAG -> GTCGATACAGT
TCTCGATCTTT -> CTCGATCTTTG
TTGGGGTTTTG -> TGGGGTTTTGG
CGGCGACGCTT -> GGCGACGCTTC
AATTTACTGCC -> ATTTACTGCCT
ATGGGCCAAGC -> TGGGCCAAGCC
AGGCATCCCTC -> GGCATCCCTCT
TGACGAAAGGT -> GACGAAAGGTA
CACAGGAGGGG -> ACAGGAGGGGG
GCGGGGCATAA -> CGGGGCATAAA
CGCATAACGTC -> GCATAACGTCT
CACAGGAGGGA -> ACAGGAGGGAG
TAGGTACTGTA -> AGGTACTGTAT
TCGAAAAGGCT -> CGAAAAGGCTC
CCCCATTAGTA -> CCCATTAGTAG
CTTCTCCTGTT -> TTCTCCTGTTG
CGGGGGATGTT -> GGGGGATGTTA
CAGAGCATCTC -> AGAGCATCTCT
CTCGTCTAGGT -> TCGTCTAGGTG
TTTAAGATGGT -> TTAAGATGGTA
AAGGCATCCCT -> AGGCATCCCTC
TCTCCTGTTGG -> CTCCTGTTGGG
ATAAGTGCCAT -> TAAGTGCCATT
CTGGCTATGTG -> TGGCTATGTGA
GAGTGTTTCGA -> AGTGTTTCGAG
TGATCTGTTAT -> GATCTGTTATT
GCCCATGTTGG -> CCCATGTTGGG
GTGGCGGGTGC -> TGGCGGGTGCC
TCATTTCTACT -> CATTTCTACTG
ATACCGTTATT -> TACCGTTATTC
ATGGGTATTCC -> TGGGTATTCCT
GGACCCTTCGG -> GACCCTTCGGA
TGTTGGGCAAC -> GTTGGGCAACT
GTTCCCCTCTC -> TTCCCCTCTCT
CTGTATATAGG -> TGTATATAGGT
AGGGCTCGTGC -> GGGCTCGTGCT
CTCGATCTTTG -> TCGATCTTTGG
CTATGTGACAG -> TATGTGACAGT
CCCCTGTCTGA -> CCCTGTCTGAT
TTCCACTGCGG -> TCCACTGCGGC
GTTTAAGACAT -> TTTAAGACATC
GCACAGGAGGG -> CACAGGAGGGG
ATGACCAAGGA -> TGACCAAGGAT
TAACAGAGATG -> AACAGAGATGG
CGATTCTTTCT -> GATTCTTTCTC
TGTTAGAGACC -> GTTAGAGACCG
CGTCCACTCGT -> GTCCACTCGTG
AGGAGGGGGAT -> GGAGGGGGATT
TTCGCCTACCG -> TCGCCTACCGT
TCAAGTAATGT -> CAAGTAATGTC
CGTGTCTTCAT -> GTGTCTTCATG
CGTCAGCGTGA -> GTCAGCGTGAT
CTATTTATTCT -> TATTTATTCTG
CCCATGGATCT -> CCATGGATCTC
GCTACCGTTGG -> CTACCGTTGGA
GACGGGGGAGC -> ACGGGGGAGCA
CGTTCTATCCT -> GTTCTATCCTG
TAAGGATTAAT -> AAGGATTAATT
TCCGCATAACG -> CCGCATAACGT
CTGGTTCCCCT -> TGGTTCCCCTC
TGGGTGCTTTG -> GGGTGCTTTGA
TCTGACGGGGG -> CTGACGGGGGA
AATCTATGGAG -> ATCTATGGAGG
TACATCCGTTC -> ACATCCGTTCT
AGATGGTATGA -> GATGGTATGAG
CAAACGACTTG -> AAACGACTTGC
ATAAGGATTAA -> TAAGGATTAAT
GGCGTCCACTC -> GCGTCCACTCG
GTTGTCTTTGT -> TTGTCTTTGTA
TGGATGGGCCA -> GGATGGGCCAA
TAACCCGGCGT -> AACCCGGCGTC
TATTCTGCGGC -> ATTCTGCGGCG
ATTCGGGTGTG -> TTCGGGTGTGA
TGGGAACTTTA -> GGGAACTTTAT
AGGTGGCCATA -> GGTGGCCATAA
ATCTCGCGACG -> TCTCGCGACGA
TCGTGAGTTCA -> CGTGAGTTCAC
GCGATACCTCT -> CGATACCTCTG
GGGACGCTGTA -> GGACGCTGTAT
ACCCCGACTTA -> CCCCGACTTAT
AGTGGGTGCTT -> GTGGGTGCTTT
TCTTTGTTTAA -> CTTTGTTTAAG
GGATATGTTAT -> GATATGTTATG
TGGTGGCGTTA -> GGTGGCGTTAC
ACCCTTCGGAT -> CCCTTCGGATG
ATAGAACTGAC -> TAGAACTGACG
CATCCGTTCTA -> ATCCGTTCTAT
GCCCTGTCTTG -> CCCTGTCTTGA
GTTAACCTAGC -> TTAACCTAGCT
CAGCTCCATTG -> AGCTCCATTGT
GAATTTTCGGA -> AATTTTCGGAG
GGTTCCCCTCT -> GTTCCCCTCTC
GTGATGAGCTA -> TGATGAGCTAA
AGAATTTATTA -> GAATTTATTAC
TCACCCGACCC -> CACCCGACCCC
AGGTAAGCAGT -> GGTAAGCAGTC
GCTTAGACTGG -> CTTAGACTGGA
CCGTGTGAGTG -> CGTGTGAGTGT
AATTTCACTGG -> ATTTCACTGGA
ACGATTCGATC -> CGATTCGATCT
TTGTTTAAGAC -> TGTTTAAGACA
TATGAGTGCGT -> ATGAGTGCGTG
TAGCTCCTACT -> AGCTCCTACTA
GGCATCCCTCT -> GCATCCCTCTT
CTAGCGCGGTT -> TAGCGCGGTTT
TTGCGATGCAT -> TGCGATGCATT
GCCTTCTCTTG -> CCTTCTCTTGC
GAGAATTTATT -> AGAATTTATTA
CTATGGAGGTG -> TATGGAGGTGG
ATTTGTAATCG -> TTTGTAATCGG
GTTAACCCCGA -> TTAACCCCGAC
ATAAATATCGC -> TAAATATCGCC
GAATTCTGATG -> AATTCTGATGG
TCTTGGCTTGC -> CTTGGCTTGCA
TCTAGCGTATG -> CTAGCGTATGG
GGGATGTTAGA -> GGATGTTAGAG
ACCACAGGAGG -> CCACAGGAGGG
GGATGATTCTC -> GATGATTCTCG
CGAAAAGGCTC -> GAAAAGGCTCA
AGAAGGATCAC -> GAAGGATCACC
AAGCTACGCAC -> AGCTACGCACA
GAGGCATTCCA -> AGGCATTCCAT
ATCGGAATTTT -> TCGGAATTTTC
GCATCCCTCTT -> CATCCCTCTTT
AGAACATTAAT -> GAACATTAATT
AGTGGGGGATT -> GTGGGGGATTC
GTAGGCCGTGT -> TAGGCCGTGTG
TTTAAGTAGTG -> TTAAGTAGTGT
CATCACATATG -> ATCACATATGT
GAAAAGGCTCA -> AAAAGGCTCAT
TTCAGCCTTTC -> TCAGCCTTTCA
AGGTGTGTTTT -> GGTGTGTTTTA
GACCCTTCGGA -> ACCCTTCGGAT
GGTCTTGGCTT -> GTCTTGGCTTG
TAGCGATACCT -> AGCGATACCTC
TTATTATTCTT -> TATTATTCTTT
CTGTTTTCAAG -> TGTTTTCAAGT
TTGGCTTCAGG -> TGGCTTCAGGG
CTTTGACAAAC -> TTTGACAAACG
TTCTATCCTGT -> TCTATCCTGTA
AGGAGAGGGCT -> GGAGAGGGCTT
GAGAAGTTCTT -> AGAAGTTCTTA
TACTGCCTTCC -> ACTGCCTTCCG
TTCAGAAGGAT -> TCAGAAGGATC
CTCGTGAGTTC -> TCGTGAGTTCA
CCGCATAACGT -> CGCATAACGTC
GTGAGTGTTTC -> TGAGTGTTTCG
TTAACCCCGAC -> TAACCCCGACT
TTATGTAACAG -> TATGTAACAGA
TTAGCGATACC -> TAGCGATACCT
ACCCGACACAT -> CCCGACACATT
TTTCAGAAGGA -> TTCAGAAGGAT
GACTTGCTACG -> ACTTGCTACGA
TCACCACAGGA -> CACCACAGGAG
GGGTGCCTTCT -> GGTGCCTTCTC
ATGAAGGCACC -> TGAAGGCACCC
TCGGCCAAGAA -> CGGCCAAGAAC
AACCCCGACTT -> ACCCCGACTTA
GGTTTCAACAT -> GTTTCAACATC
GCCTGGTTCAC -> CCTGGTTCACT
TTCACTAGAGC -> TCACTAGAGCA
CTAGGGAGGTC -> TAGGGAGGTCT
TCTGGGAGAAT -> CTGGGAGAATT
AGCTACGCACA -> GCTACGCACAG
CGCGTCTGGGA -> GCGTCTGGGAA
GATCTGTGAGG -> ATCTGTGAGGT
CCTGAAGGCTG -> CTGAAGGCTGG
AACGATTCGAT -> ACGATTCGATC
AATAGAACTGA -> ATAGAACTGAC
TGCCAGTATCA -> GCCAGTATCAA
AGATACCGACA -> GATACCGACAC
CAGAGATGGTG -> AGAGATGGTGG
GGGTTTTGGCT -> GGTTTTGGCTT
TTTCAAGTAAT -> TTCAAGTAATG
TGGCGTTACGC -> GGCGTTACGCC
GTGCTATGAGT -> TGCTATGAGTG
CGGGGATACGA -> GGGGATACGAT
ATTATGCGAGG -> TTATGCGAGGT
GTTCACTCAAG -> TTCACTCAAGA
ACTATGACCAA -> CTATGACCAAG
CCTTCGGATGG -> CTTCGGATGGG
TTGTAATCGGA -> TGTAATCGGAA
ATCCCCCTGTC -> TCCCCCTGTCT
GAGGGCTTAGC -> AGGGCTTAGCA
ATGTAAGGGTC -> TGTAAGGGTCG
CTTCATTTCTA -> TTCATTTCTAC
CCGACACCCCA -> CGACACCCCAT
AGATTCTAGGG -> GATTCTAGGGA
GAAACCTGCCC -> AAACCTGCCCC
GTTCTTACACA -> TTCTTACACAA
AGCAGTCAAGC -> GCAGTCAAGCT
TGCGGCTCCAC -> GCGGCTCCACA
AATTGAGAATA -> ATTGAGAATAA
GTTCCTGGTCG -> TTCCTGGTCGA
TGGCTTCAGGG -> GGCTTCAGGGC
GATGGACTCCG -> ATGGACTCCGC
ATGTGACAGTT -> TGTGACAGTTA
GCGCTAAAATG -> CGCTAAAATGC
CCCGACTTATG -> CCGACTTATGA
ACTACTCGGCC -> CTACTCGGCCA
AGTGCGTGGAG -> GTGCGTGGAGA
GTCTGATGATA -> TCTGATGATAC
ATTGTCTGACG -> TTGTCTGACGG
ATCTGTTATTG -> TCTGTTATTGT
ACTCTAGCGCG -> CTCTAGCGCGG
TCTCTTGCCAG -> CTCTTGCCAGA
TCGATCTGGGA -> CGATCTGGGAG
GTTCTAGAAAA -> TTCTAGAAAAT
GGCTCGTGCTA -> GCTCGTGCTAT
GTGGATGGACT -> TGGATGGACTC
GGGCGACGCTG -> GGCGACGCTGG
GGGAGACAATC -> GGAGACAATCC
CATGGTGGTTA -> ATGGTGGTTAA
CTGAAGGCTGG -> TGAAGGCTGGA
CGCCCGGGTGG -> GCCCGGGTGGG
CTAACGTGTGG -> TAACGTGTGGG
ATGCCAGTATC -> TGCCAGTATCA
GCGACGATCTA -> CGACGATCTAT
TGGGGCCGGGG -> GGGGCCGGGGA
TAAAACGATTC -> AAAACGATTCG
CCATTTATTAT -> CATTTATTATG
ATGAGCTAACA -> TGAGCTAACAA
TGCCTTCCGCT -> GCCTTCCGCTA
CAAGATGAAGG -> AAGATGAAGGC
ATCTGGGAGAA -> TCTGGGAGAAT
GACGCTGGACA -> ACGCTGGACAT
TTTTAACTTTT -> TTTAACTTTTG
TTAAGTAGTGT -> TAAGTAGTGTC
CAGTTTTAGCG -> AGTTTTAGCGA
CTTGCAAGGCA -> TTGCAAGGCAT
CTGATACTACT -> TGATACTACTC
TTCATTTCTAC -> TCATTTCTACT
GAAGGATCACC -> AAGGATCACCT
GAGAATAGAAC -> AGAATAGAACT
CCTGGTCGATA -> CTGGTCGATAC
TCTTTCTCTAA -> CTTTCTCTAAA
GCAGCCCATGT -> CAGCCCATGTT
TGAGTGGCGGG -> GAGTGGCGGGT
TTAGTTGGTGG -> TAGTTGGTGGC
TAAGCAGTCAA -> AAGCAGTCAAG
CTTGCCAGAAA -> TTGCCAGAAAA
TCTGCGGCGAC -> CTGCGGCGACG
GTGTACATCCG -> TGTACATCCGT
ATATGTTGTCT -> TATGTTGTCTT
GTATGAGTGGG -> TATGAGTGGGG
ACGCGTCTGGG -> CGCGTCTGGGA
CCAACATGGGG -> CAACATGGGGC
TTCGGATGGGG -> TCGGATGGGGT
GCTCATTATCG -> CTCATTATCGT
GGGGGATTTGC -> GGGGATTTGCG
CCGTTGGAGGA -> CGTTGGAGGAC
GTGGGCCGCTC -> TGGGCCGCTCG
GTCTTCATGAT -> TCTTCATGATC
CGATCTTTGGC -> GATCTTTGGCT
CAGAAACCTGC -> AGAAACCTGCC
CGTTGGAGGAC -> GTTGGAGGACG
TTTGACCTTTG -> TTGACCTTTGA
GGCCGCTCGTT -> GCCGCTCGTTC
TCACTCAAGAT -> CACTCAAGATG
CTACTGGATTC -> TACTGGATTCC
CTGGTCGATAC -> TGGTCGATACA
GTATTCCTGGT -> TATTCCTGGTC
GTCCACTCGTG -> TCCACTCGTGA
TGATACTACTC -> GATACTACTCG
ATGCATTCTCA -> TGCATTCTCAA
TCTCCTATTCA -> CTCCTATTCAG
TGGGACGCTGT -> GGGACGCTGTA
AACATGGGGCC -> ACATGGGGCCG
CCACTGCGGCT -> CACTGCGGCTC
CCCATTCCACA -> CCATTCCACAA
CGTTCTCGTCT -> GTTCTCGTCTA
GCATTCTCAAT -> CATTCTCAATA
TGTATATAGGT -> GTATATAGGTA
TTCAACATCAC -> TCAACATCACA
CTAGCGTATGG -> TAGCGTATGGA
TTTCTCTAAAT -> TTCTCTAAATT
CTCTTTAAGAT -> TCTTTAAGATG
AGTTACTCTAG -> GTTACTCTAGC
AACTTTTGCAT -> ACTTTTGCATT
GACGATCTATC -> ACGATCTATCG
GTTTCAACATC -> TTTCAACATCA
AAGGATCACCT -> AGGATCACCTC
ATTCTCGGGGT -> TTCTCGGGGTA
AGCAAACGACT -> GCAAACGACTT
CCACAGGAGGG -> CACAGGAGGGA
GCGGGTGCCTT -> CGGGTGCCTTC
ATTCTTTCTCT -> TTCTTTCTCTA
GTCAAGCTACG -> TCAAGCTACGC
GTGTCGGTGAC -> TGTCGGTGACA
TATCGTGGTGG -> ATCGTGGTGGT
CGGCTGTTAAC -> GGCTGTTAACC
TTAGGGCGACG -> TAGGGCGACGC
CGGGTGTGAGT -> GGGTGTGAGTG
ACTATGGCGGG -> CTATGGCGGGG
AGCGTGATTTT -> GCGTGATTTTA
GCTGGAACTGC -> CTGGAACTGCG
TGTGTTTTAAC -> GTGTTTTAACT
GTTTTCAAGTA -> TTTTCAAGTAA
TACAGTTTTAG -> ACAGTTTTAGC
AGGTACTGTAT -> GGTACTGTATC
GGGCATAAAAT -> GGCATAAAATT
GCGATTCTAAC -> CGATTCTAACC
GATTCCGGCGG -> ATTCCGGCGGG
ATCGCGATTCT -> TCGCGATTCTA
CGAACGTACAT -> GAACGTACATT
TATAAATATCG -> ATAAATATCGC
GGTGGATGGAC -> GTGGATGGACT
GTCCAAGTGTT -> TCCAAGTGTTG
TCGTTCTAGAA -> CGTTCTAGAAA
GTAGGTCTCAG -> TAGGTCTCAGA
ATGATCGCGAT -> TGATCGCGATT
CGGCAGCCCAT -> GGCAGCCCATG
CTTTATTATTC -> TTTATTATTCT
GGTGGTTAACC -> GTGGTTAACCC
GAACATTAATT -> AACATTAATTT
GTGGTAGTGGG -> TGGTAGTGGGT
GACCAACATGG -> ACCAACATGGG
TATGTCTCCTA -> ATGTCTCCTAT
AGGGTCGTCCA -> GGGTCGTCCAA
AGTCTATGCCA -> GTCTATGCCAG
ACTTGCTACGA -> CTTGCTACGAT
AGAGATGGTGG -> GAGATGGTGGA
TTCTGATGGGT -> TCTGATGGGTC
GTGTCTTCATG -> TGTCTTCATGA
GTCCGGCTGTT -> TCCGGCTGTTA
GCTATGAGTGC -> CTATGAGTGCG
TTGCATTCCGT -> TGCATTCCGTT
AAGAGTGTACA -> AGAGTGTACAT
TTAAGATGGTA -> TAAGATGGTAT
ATTCTGCGGCG -> TTCTGCGGCGA
GGATGGACTCC -> GATGGACTCCG
CTGCCTTCCGC -> TGCCTTCCGCT
CCTCTCTATGT -> CTCTCTATGTC
TCGTGGTGGTA -> CGTGGTGGTAG
GTCTATGCCAG -> TCTATGCCAGT
TGACGGGGGAG -> GACGGGGGAGC
CTACTATGACC -> TACTATGACCA
CACGGTCTATA -> ACGGTCTATAA
TGGGCCAAGCC -> GGGCCAAGCCC
CTGTCTTGATT -> TGTCTTGATTA
TCTTACACAAA -> CTTACACAAAG
GTCGTAAACCG -> TCGTAAACCGG
ATTGAGAATAA -> TTGAGAATAAT
CGGTTTCAACA -> GGTTTCAACAT
GGTTAACCCCG -> GTTAACCCCGA
GACCAAGGATC -> ACCAAGGATCT
TAGTGGGTGCT -> AGTGGGTGCTT
TGTTGGGGTTT -> GTTGGGGTTTT
TATGGAATAGG -> ATGGAATAGGA
GCGGAAGATAC -> CGGAAGATACC
GCAGTCAAGCT -> CAGTCAAGCTA
AGACCGAACGT -> GACCGAACGTA
CTCCTATTCAG -> TCCTATTCAGC
AAGGCTCATTA -> AGGCTCATTAT
AACGCGTGTCG -> ACGCGTGTCGA
GTGTCGCAGAA -> TGTCGCAGAAA
TTCCGTTACTG -> TCCGTTACTGG
ACATTCACGAA -> CATTCACGAAA
AGGCACCCGAC -> GGCACCCGACA
CGTGGTGGTAG -> GTGGTGGTAGT
CGGTCTATAAA -> GGTCTATAAAC
TCCAAGGTGTG -> CCAAGGTGTGT
GTTTTAACTTT -> TTTTAACTTTT
AAATCCCCATT -> AATCCCCATTC
ACTTTATTATT -> CTTTATTATTC
AAACTTGAATT -> AACTTGAATTT
GGAACTTTATT -> GAACTTTATTA
ATAACGTCTGT -> TAACGTCTGTG
AGTGTACATCC -> GTGTACATCCG
GGTGGCCATAA -> GTGGCCATAAT
TTGGGCAACTA -> TGGGCAACTAT
GGTCTGATACT -> GTCTGATACTA
CCCTGTCTTGA -> CCTGTCTTGAT
CGTGGAGAAGC -> GTGGAGAAGCT
GATGGGCCAAG -> ATGGGCCAAGC
AGTAGTGTCGC -> GTAGTGTCGCA
GCTGGACATAA -> CTGGACATAAG
GGGATTTGCGA -> GGATTTGCGAT
CGCTATCAACG -> GCTATCAACGC
CTATGAGTGCG -> TATGAGTGCGT
CCGGGGATACG -> CGGGGATACGA
TGAATTCTGAT -> GAATTCTGATG
GTAAAACGATT -> TAAAACGATTC
TTGATTATAAA -> TGATTATAAAT
ACTGACGAAAG -> CTGACGAAAGG
ACTGGTTCCCC -> CTGGTTCCCCT
TGGATTCCGGC -> GGATTCCGGCG
ATAATCTCCAA -> TAATCTCCAAG
GGGATACGATA -> GGATACGATAA
ATCCTGTAGGC -> TCCTGTAGGCC
AGAGCATCTCT -> GAGCATCTCTA
GTTTTAGCGAT -> TTTTAGCGATA
AAAGGTAAGCA -> AAGGTAAGCAG
CTCCTACTATG -> TCCTACTATGA
GCCTTCCGCTA -> CCTTCCGCTAT
ACTTATGATTT -> CTTATGATTTG
AGGATTAATTT -> GGATTAATTTA
CCTTCCGCTAT -> CTTCCGCTATC
TCATTATCGTG -> CATTATCGTGT
CATAAGGATTA -> ATAAGGATTAA
GAGTGGCGGGT -> AGTGGCGGGTG
GGTGGGCGATT -> GTGGGCGATTC
GGTAGATTCTA -> GTAGATTCTAG
GGATGTTAGAG -> GATGTTAGAGA
CGTGTCGGTGA -> GTGTCGGTGAC
CGCGTTCTCGT -> GCGTTCTCGTC
TGAGTGTTTCG -> GAGTGTTTCGA
AAATATCGCCT -> AATATCGCCTA
AGTGGCGGGTG -> GTGGCGGGTGC
TAAGGGTCGTC -> AAGGGTCGTCC
TTAGACTGGAT -> TAGACTGGATG
TACGATAAGTG -> ACGATAAGTGC
CACACGGTCTA -> ACACGGTCTAT
GACAGTTACTC -> ACAGTTACTCT
TAAGATGGTAT -> AAGATGGTATG
GATCTTTGGCT -> ATCTTTGGCTC
GATTCTAGGGA -> ATTCTAGGGAG
AAGCAGTCAAG -> AGCAGTCAAGC
TTGCGCGCTAA -> TGCGCGCTAAA
TGGTATGAGTG -> GGTATGAGTGG
CCTTTGACAAA -> CTTTGACAAAC
CTATGCCAGTA -> TATGCCAGTAT
ATCAATTGAAT -> TCAATTGAATT
GGGTCGTCCAA -> GGTCGTCCAAG
ACTCGTGAGTT -> CTCGTGAGTTC
TAGCGCGGTTT -> AGCGCGGTTTC
CATAAAATTGA -> ATAAAATTGAG
CGATCTGGGAG -> GATCTGGGAGA
ATTGCAGCGTA -> TTGCAGCGTAA
TCCTATTCAGC -> CCTATTCAGCC
TGCCAGAAAAG -> GCCAGAAAAGA
GGGCTCGTGCT -> GGCTCGTGCTA
TGTCTTTAGCC -> GTCTTTAGCCG
GGCGATTCTTT -> GCGATTCTTTC
TCTTTAGGGCG -> CTTTAGGGCGA
CTCATTATCGT -> TCATTATCGTG
ACTCAAGATGA -> CTCAAGATGAA
GACCTTTGACA -> ACCTTTGACAA
CCTACCGTGTC -> CTACCGTGTCT
GTTGCTTATAG -> TTGCTTATAGC
CCTTCTCTTGC -> CTTCTCTTGCC
TGACAAACGCG -> GACAAACGCGT
CCTCTCGATCT -> CTCTCGATCTT
GGGGCCGGGGA -> GGGCCGGGGAT
ATTCCTGGTCG -> TTCCTGGTCGT
ACTTTTGCATT -> CTTTTGCATTC
GTGTGGGACGC -> TGTGGGACGCT
AACAGAGATGG -> ACAGAGATGGT
GGTTTTGGCTT -> GTTTTGGCTTC
TCCGCTATCAA -> CCGCTATCAAC
CTAACAAACCG -> TAACAAACCGG
TAGACTGGATG -> AGACTGGATGG
TAACAGCGTAA -> AACAGCGTAAT
TTCAGGGCTCG -> TCAGGGCTCGT
GGAGGGAGAGT -> GAGGGAGAGTT
CGCAGAAACCT -> GCAGAAACCTG
TAAGACATCAG -> AAGACATCAGA
ATGGACTCCGC -> TGGACTCCGCA
GTTATTGTCTG -> TTATTGTCTGA
ATTCTGATGGG -> TTCTGATGGGT
TGAGTCTATGC -> GAGTCTATGCC
TAACAAACCGG -> AACAAACCGGC
ATGTTAGAGAC -> TGTTAGAGACC
GGAGCACAGGA -> GAGCACAGGAG
ACAGTTATGGT -> CAGTTATGGTC
GCTTGCAAGGC -> CTTGCAAGGCA
TGGAACTGCGC -> GGAACTGCGCG
CACCCGACCCC -> ACCCGACCCCT
AGAAGCTTTAT -> GAAGCTTTATG
GCCATAATCTC -> CCATAATCTCC
GCTAAAATGCT -> CTAAAATGCTC
TCGTCTAGGTG -> CGTCTAGGTGT
ACCTGAATAAC -> CCTGAATAACC
ACCAACATGGG -> CCAACATGGGG
CATTAGTAGTC -> ATTAGTAGTCC
AATTCTGATGG -> ATTCTGATGGG
GTTGAACCCAT -> TTGAACCCATG
TCTGGTAGATT -> CTGGTAGATTC
GGGTGCTTTGA -> GGTGCTTTGAC
TCTTGCCAGAA -> CTTGCCAGAAA
ACTAGAGGCAT -> CTAGAGGCATT
CCCCCTGTCTG -> CCCCTGTCTGA
CTTGATTATAA -> TTGATTATAAA
ATCTGTTTTCA -> TCTGTTTTCAA
CTCTTGCCAGA -> TCTTGCCAGAA
GACACCCCATT -> ACACCCCATTA
ACGTACATTCA -> CGTACATTCAC
GTGCGTGGAGA -> TGCGTGGAGAA
ACGCTGTATAT -> CGCTGTATATA
CCTGAGTCTAT -> CTGAGTCTATG
GGCAACTATGG -> GCAACTATGGC
GATCACCTCTC -> ATCACCTCTCG
ACAGCGTAATC -> CAGCGTAATCG
CAAACCGGCAG -> AAACCGGCAGC
GTCGAAAAGGC -> TCGAAAAGGCT
AGTTTTAGCGA -> GTTTTAGCGAT
ACGTCAGCGTG -> CGTCAGCGTGA
TTATAAATATC -> TATAAATATCG
ATCCGTTCTAT -> TCCGTTCTATC
ACTGGATTCCG -> CTGGATTCCGG
TAGATTCTAGG -> AGATTCTAGGG
GGTATGAGTGG -> GTATGAGTGGG
GTCTTTGTAAC -> TCTTTGTAACA
TTTATTATTCT -> TTATTATTCTT
TGATTCTCGGG -> GATTCTCGGGG
AGCACAGGAGG -> GCACAGGAGGG
AACGTACATTC -> ACGTACATTCA
AGATGGTGGAT -> GATGGTGGATG
GTTACTCTAGC -> TTACTCTAGCG
TGATACCGTTA -> GATACCGTTAT
GCGGCTCCACA -> CGGCTCCACAC
TTATGCGGTTT -> TATGCGGTTTG
ATCCCCATTCC -> TCCCCATTCCA
GATGGTATGAG -> ATGGTATGAGT
CCGGGAGACAA -> CGGGAGACAAT
ACAAAGAGTGT -> CAAAGAGTGTA
ACCGTTATTCC -> CCGTTATTCCA
CTATCAACGCG -> TATCAACGCGT
ACACAAAGAGT -> CACAAAGAGTG
GTCTTTAGCCG -> TCTTTAGCCGT
TATGTAAGGGT -> ATGTAAGGGTC
GATACGATAAG -> ATACGATAAGT
GAATAATCTAT -> AATAATCTATG
GCGCGGAAGAT -> CGCGGAAGATA
AGCAGAGCATC -> GCAGAGCATCT
GCTCGTGCTAT -> CTCGTGCTATG
TTGTCTGATCT -> TGTCTGATCTG
TTTGCGCGCTA -> TTGCGCGCTAA
CGCTACCGTTG -> GCTACCGTTGG
ACCCGACCCCT -> CCCGACCCCTG
GCGGTTTGCGC -> CGGTTTGCGCG
AGCCCTGTCTT -> GCCCTGTCTTG
CGTTCTAGAAA -> GTTCTAGAAAA
TACCGTGTCTT -> ACCGTGTCTTC
ATTTACTGCCT -> TTTACTGCCTT
GTCTGTGGGCC -> TCTGTGGGCCG
AATCGGAATTT -> ATCGGAATTTT
GATGGGGTTTA -> ATGGGGTTTAG
CACATTCACCA -> ACATTCACCAC
GATTAATTTAC -> ATTAATTTACT
CTTAGACTGGA -> TTAGACTGGAT
CCCCATTCCAC -> CCCATTCCACA
GAAGATACCGA -> AAGATACCGAC
CAGCGTGATTT -> AGCGTGATTTT
TTGGATGATTC -> TGGATGATTCT
AGCCCATGTTG -> GCCCATGTTGG
GTGTGAGTGGC -> TGTGAGTGGCG
TGAACCCATGG -> GAACCCATGGA
TCTTTGTAACA -> CTTTGTAACAG
CCGGGTGGGCG -> CGGGTGGGCGA
ACCCGGCGTCC -> CCCGGCGTCCA
GCTTATAGCTC -> CTTATAGCTCC
ACACGGTCTAT -> CACGGTCTATA
AACTATGGCGG -> ACTATGGCGGG
TCTCCAAGGTG -> CTCCAAGGTGT
GTCGGTGACAT -> TCGGTGACATG
CGCGTGTCGAA -> GCGTGTCGAAA
AGAGCAAACGA -> GAGCAAACGAC
CTGGTAGATTC -> TGGTAGATTCT
TTGAATTCTGA -> TGAATTCTGAT
CCTGGCTATGT -> CTGGCTATGTG
CGGCGTCCACT -> GGCGTCCACTC
CTGGGAACTTT -> TGGGAACTTTA
CCTATTTATTC -> CTATTTATTCT
TAGTGTCGCAG -> AGTGTCGCAGA
ATTCTAGGGAG -> TTCTAGGGAGG
AGACGCGTTCT -> GACGCGTTCTC
CTCCGCATAAC -> TCCGCATAACG
CGACGCTGGAC -> GACGCTGGACA
CATTCACGAAA -> ATTCACGAAAG
GTCTCCTATTC -> TCTCCTATTCA
AGACAGTTACT -> GACAGTTACTC
TCTATAAACTT -> CTATAAACTTG
GGTGCTTTGAC -> GTGCTTTGACC
TTTGACAAACG -> TTGACAAACGC
GACTGGATGGG -> ACTGGATGGGC
GCGACGCTGGA -> CGACGCTGGAC
TTTACTGCCTT -> TTACTGCCTTC
ATGGTCTGATA -> TGGTCTGATAC
GTCTTGATTAT -> TCTTGATTATA
GTTGGTGGCGT -> TTGGTGGCGTT
AAGCGTGATGA -> AGCGTGATGAG
GCTCCTACTAT -> CTCCTACTATG
GTGATTTTAAG -> TGATTTTAAGT
TGTTATGTAAC -> GTTATGTAACA
CATTAATTTTG -> ATTAATTTTGA
ACTGTATCACC -> CTGTATCACCC
GTTATGTAACA -> TTATGTAACAG
ACCTAGCTTAG -> CCTAGCTTAGA
TCTCGTCTAGG -> CTCGTCTAGGT
ATGGCGGGGCA -> TGGCGGGGCAT
ACATCAGACAG -> CATCAGACAGT
GGAGTTGAACC -> GAGTTGAACCC
CGATAAGTGCC -> GATAAGTGCCA
AACGCTACCGT -> ACGCTACCGTT
GACGCTGTATA -> ACGCTGTATAT
GCATAAAATTG -> CATAAAATTGA
AATTTTCGGAG -> ATTTTCGGAGG
AGGATCTGTGA -> GGATCTGTGAG
AAGGATCTGTG -> AGGATCTGTGA
CCGGCGTCCAC -> CGGCGTCCACT
ACTAATCAGCG -> CTAATCAGCGC
CTGTGGGCCGC -> TGTGGGCCGCT
CGACGATCTAT -> GACGATCTATC
GCTTTGACCTT -> CTTTGACCTTT
GCCTACCGTGT -> CCTACCGTGTC
GACGCTTCATT -> ACGCTTCATTT
TGACATGATCG -> GACATGATCGC
AAGCTTTATGC -> AGCTTTATGCG
CGCGGAAGATA -> GCGGAAGATAC
CTCCACACTAG -> TCCACACTAGA
CTGGACATAAG -> TGGACATAAGG
GTCTGACGGGG -> TCTGACGGGGG
CGTACATTCAC -> GTACATTCACG
GCTCTTTGTTT -> CTCTTTGTTTA
TGGAGGACGTC -> GGAGGACGTCA
GGGGTTTAGCG -> GGGTTTAGCGC
GTTTAGCGCGG -> TTTAGCGCGGA
GAGGTCTTGGC -> AGGTCTTGGCT
AGAAAATCCCC -> GAAAATCCCCA
AAAATCCCCAT -> AAATCCCCATT
TAGGTCTCAGA -> AGGTCTCAGAG
GCGGGGGATGT -> CGGGGGATGTT
TCACCTCTCGA -> CACCTCTCGAT
GGGCAACTATG -> GGCAACTATGG
TGGGTCTAAGC -> GGGTCTAAGCG
GAGTTAGTTGG -> AGTTAGTTGGT
GCAAGGCATCC -> CAAGGCATCCC
GGAGGTGGCCA -> GAGGTGGCCAT
TCTCTAGCGTA -> CTCTAGCGTAT
GCGTTACGCCC -> CGTTACGCCCG
GTTTTGGCTTC -> TTTTGGCTTCA
AAGGCTGGAAC -> AGGCTGGAACT
TTCTCTTGCCA -> TCTCTTGCCAG
TCCCTCTTTAA -> CCCTCTTTAAG
TGAAGGCACCC -> GAAGGCACCCG
TGTCGGTGACA -> GTCGGTGACAT
TATGTAACAGA -> ATGTAACAGAG
TGTTTCGAGAC -> GTTTCGAGACG
GATTTGTAATC -> ATTTGTAATCG
ATAAACTTGAA -> TAAACTTGAAT
TGCGGCGACGC -> GCGGCGACGCT
AGCGTGATGAG -> GCGTGATGAGC
GCGTGGAGAAG -> CGTGGAGAAGC
AGCATCTCTAG -> GCATCTCTAGC
CAGAAAAGATG -> AGAAAAGATGA
TCAGGGCTCGT -> CAGGGCTCGTG
GTTACTGGTTC -> TTACTGGTTCC
TAGCAACTAAT -> AGCAACTAATC
TAGCGCGGAAG -> AGCGCGGAAGA
TACTATGACCA -> ACTATGACCAA
GTCTAGGTGTG -> TCTAGGTGTGA
CGCGCACACGG -> GCGCACACGGT
CAACATCACAT -> AACATCACATA
TCCATAGGTAC -> CCATAGGTACT
TTTCGGAGGAG -> TTCGGAGGAGT
GTTCTATCCTG -> TTCTATCCTGT
TAACCCCGACT -> AACCCCGACTT
ATGTTGTCTTT -> TGTTGTCTTTG
GAGTTCACTCA -> AGTTCACTCAA
TCAGAAGGATC -> CAGAAGGATCA
TGTTTTCAAGT -> GTTTTCAAGTA
GTGACCTGAAT -> TGACCTGAATA
GATGGTGGATG -> ATGGTGGATGG
CGTTATTCCAC -> GTTATTCCACT
ATGGGGTTTAG -> TGGGGTTTAGC
AATAATCTATG -> ATAATCTATGG
ATCGCCTATTT -> TCGCCTATTTA
AACGTGTGGGA -> ACGTGTGGGAC
TCTCAGAGAAT -> CTCAGAGAATA
TTTTCGGAGGA -> TTTCGGAGGAG
TATTATGCGAG -> ATTATGCGAGG
TAGAGGCATTC -> AGAGGCATTCC
GGCGACGCTTC -> GCGACGCTTCA
CCTGACCAACA -> CTGACCAACAT
ACGATAAGTGC -> CGATAAGTGCC
AAGATGAAGGA -> AGATGAAGGAG
AAGATGAAGGC -> AGATGAAGGCA
TCGATCTTTGG -> CGATCTTTGGC
AACGTCTGTGG -> ACGTCTGTGGG
TTAGAGACCGA -> TAGAGACCGAA
ACATGATCGCG -> CATGATCGCGA
CGTCTGTGGGC -> GTCTGTGGGCC
TTGACCTTTGA -> TGACCTTTGAC
ATTTGCGATGC -> TTTGCGATGCA
GGGCCAAGCCC -> GGCCAAGCCCT
TATGCCAGTAT -> ATGCCAGTATC
ATTGGATGATT -> TTGGATGATTC
GAGACCGAACG -> AGACCGAACGT
AGCGCGGAAGA -> GCGCGGAAGAT
ACTCCGCATAA -> CTCCGCATAAC
TGGCTCCGTCT -> GGCTCCGTCTT
ACGCTACCGTT -> CGCTACCGTTG
ACGCGTTCTCG -> CGCGTTCTCGT
TCTAAATTGGA -> CTAAATTGGAT
AAGATACCGAC -> AGATACCGACA
TTTGGCTCCGT -> TTGGCTCCGTC
ATTTCACTGGA -> TTTCACTGGAT
GGAAGATACCG -> GAAGATACCGA
GGCACCCGACA -> GCACCCGACAC
CTATTCAGCCT -> TATTCAGCCTT
TCCACAACGCT -> CCACAACGCTA
GGTGTGACCTG -> GTGTGACCTGA
TTCGATCTGGG -> TCGATCTGGGA
AAGTGTTGCTT -> AGTGTTGCTTA
CTCTTTGTTTA -> TCTTTGTTTAA
TCTCTATGTCT -> CTCTATGTCTC
TGAGTGGGGGA -> GAGTGGGGGAT
TATAGGTAGGT -> ATAGGTAGGTC
AGACATCAGAC -> GACATCAGACA
CGCGCTAAAAT -> GCGCTAAAATG
GTCAGCGTGAT -> TCAGCGTGATT
TGGCTATGTGA -> GGCTATGTGAC
CTGGTCGTAAA -> TGGTCGTAAAC
GGCCAAGAACA -> GCCAAGAACAT
CGGGTGCCTTC -> GGGTGCCTTCT
GTAATGTCTTT -> TAATGTCTTTA
CATAATCTCCA -> ATAATCTCCAA
CATGATCGCGA -> ATGATCGCGAT
TTTTGCATTCC -> TTTGCATTCCG
GCGACGCTTCA -> CGACGCTTCAT
TTCTTACACAA -> TCTTACACAAA
GTCTTGGCTTG -> TCTTGGCTTGC
GCACAGCTCCA -> CACAGCTCCAT
AAACGCGTCTG -> AACGCGTCTGG
CCTAGCTTAGA -> CTAGCTTAGAC
CTTTAGGGCGA -> TTTAGGGCGAC
ATTATAAATAT -> TTATAAATATC
TATTCGCCTAC -> ATTCGCCTACC
TTTAGGGCGAC -> TTAGGGCGACG
GCCAGTATCAA -> CCAGTATCAAT
GACGAAAGGTA -> ACGAAAGGTAA
GGACGTCAGCG -> GACGTCAGCGT
TCACTAGAGCA -> CACTAGAGCAA
TTATGGTCTGA -> TATGGTCTGAT
ATTCTTTAGGG -> TTCTTTAGGGC
TATCGCCTATT -> ATCGCCTATTT
TCGGGTGTGAG -> CGGGTGTGAGT
CTGGATTCCGG -> TGGATTCCGGC
CCACAACGCTA -> CACAACGCTAC
CGATTGCAGCG -> GATTGCAGCGT
ATGGGTCTAAG -> TGGGTCTAAGC
GGCTTAGCAAC -> GCTTAGCAACT
GGTTTAGCGCG -> GTTTAGCGCGG
ACCGGCAGCCC -> CCGGCAGCCCA
TGCAGCAGAGC -> GCAGCAGAGCA
TGGATGATTCT -> GGATGATTCTC
TGAATAACCAT -> GAATAACCATG
TGTAACAGAGA -> GTAACAGAGAT, GTAACAGAGAA
CCGGCTGTTAA -> CGGCTGTTAAC
GCTCGTTCTAG -> CTCGTTCTAGA
TTAACAGCGTA -> TAACAGCGTAA
GTGGGGGATTC -> TGGGGGATTCG
CAAACGCGTCT -> AAACGCGTCTG
GGCTGGAACTG -> GCTGGAACTGC
TTTAGCGCGGA -> TTAGCGCGGAA
GAAGGCTGGAA -> AAGGCTGGAAC
CCTGTAGGCCG -> CTGTAGGCCGT
ACGCTTCATTT -> CGCTTCATTTC
AGGCCGTGTGA -> GGCCGTGTGAG
CTAGAGGCATT -> TAGAGGCATTC
CCTGTCTTGAT -> CTGTCTTGATT
CAAGGTGTGTT -> AAGGTGTGTTT
GAGAATAATCT -> AGAATAATCTA
TGCAGCGTAAC -> GCAGCGTAACA
AACATTAATTT -> ACATTAATTTT
ACCGACACCCC -> CCGACACCCCA
AGGACCCTTCG -> GGACCCTTCGG
TATCAACGCGT -> ATCAACGCGTG
CGTCTAGGTGT -> GTCTAGGTGTG
AATCAGCGCTT -> ATCAGCGCTTA
CTCCAAGGTGT -> TCCAAGGTGTG
CCCTGGCTATG -> CCTGGCTATGT
CAGAGAATAGA -> AGAGAATAGAA
TAGCGTATGGA -> AGCGTATGGAA
GGGTTTAGCGC -> GGTTTAGCGCG
CAGCAGAGCAT -> AGCAGAGCATC
TATCACCCGAC -> ATCACCCGACC
GTACATTCACG -> TACATTCACGA
AGTGCCATTTA -> GTGCCATTTAT
TGGTCGTAAAC -> GGTCGTAAACC
AGGGAGGTCTT -> GGGAGGTCTTG
AGTTGAACCCA -> GTTGAACCCAT
TGTCTTTGTAA -> GTCTTTGTAAC
CATTCCGTTAC -> ATTCCGTTACT
ATATCGCCTAT -> TATCGCCTATT
GGCGACGCTGG -> GCGACGCTGGA
CAAGCCCTGTC -> AAGCCCTGTCT
GCGCGGTTTCA -> CGCGGTTTCAA
GCAGCAGAGCA -> CAGCAGAGCAT
ATGGGGCCGGG -> TGGGGCCGGGG
AACATCACATA -> ACATCACATAT
CAACTATGGCG -> AACTATGGCGG
TTGCCAGAAAA -> TGCCAGAAAAG
GGCCAAGCCCT -> GCCAAGCCCTG
GCGCGGCTAAC -> CGCGGCTAACG
TCGATACAGTT -> CGATACAGTTT
GGAGGACGTCA -> GAGGACGTCAG
CGGAGGAGTTG -> GGAGGAGTTGA
GGAATAGGACC -> GAATAGGACCC
AGCTCCTACTA -> GCTCCTACTAT
AACCATGGTGG -> ACCATGGTGGT
ACAACGCTACC -> CAACGCTACCG
CCAAGTGTTGC -> CAAGTGTTGCT
TCGTGCTATGA -> CGTGCTATGAG
CCCATTAGTAG -> CCATTAGTAGT
ATACGATAAGT -> TACGATAAGTG
GGCTATGTGAC -> GCTATGTGACA
ACCCCTGACCA -> CCCCTGACCAA
ATGCGGTTTGC -> TGCGGTTTGCG
GTGTCGAAAAG -> TGTCGAAAAGG
TTGCTTATAGC -> TGCTTATAGCT
GCTGTTAACCT -> CTGTTAACCTA
TATGGTCTGAT -> ATGGTCTGATA
GATTCTTTCTC -> ATTCTTTCTCT
GAGGTGCAGCA -> AGGTGCAGCAG
AAAATTGAGAA -> AAATTGAGAAT
GTCTATAAACT -> TCTATAAACTT
ACTTGAATTTC -> CTTGAATTTCA
TGATCGCGATT -> GATCGCGATTC
ATAGCTCCTAC -> TAGCTCCTACT
TGTTGCTTATA -> GTTGCTTATAG
GCGATTCTTTC -> CGATTCTTTCT
GCTACGATTGC -> CTACGATTGCA
GGGAACTTTAT -> GGAACTTTATT
CGCACACGGTC -> GCACACGGTCT
GCGTCTGGGAA -> CGTCTGGGAAC
TGGACATAAGG -> GGACATAAGGA
CAGAGAAGTTC -> AGAGAAGTTCT
ATACCGACACC -> TACCGACACCC
TTCCGGCGGGG -> TCCGGCGGGGG
TTCACTGGATA -> TCACTGGATAT
TCCACTGCGGC -> CCACTGCGGCT
GAGATGGTGGA -> AGATGGTGGAT
TTCTAACCCGG -> TCTAACCCGGC
ATTTTCGGAGG -> TTTTCGGAGGA
TTACACCCTGG -> TACACCCTGGC
CGTCTGGGAAC -> GTCTGGGAACT
AGCTTTATGCG -> GCTTTATGCGG
GGGGTTTTGGC -> GGGTTTTGGCT
TATGATTTGTA -> ATGATTTGTAA
TTAATTTTGAT -> TAATTTTGATG
CTGCGGCTCCA -> TGCGGCTCCAC
CAATCCCCCTG -> AATCCCCCTGT
CAACATGGGGC -> AACATGGGGCC
ATAGGACCCTT -> TAGGACCCTTC
TCTCGGGGTAA -> CTCGGGGTAAA
TCGGGGTAAAA -> CGGGGTAAAAC
GGGCGATTCTT -> GGCGATTCTTT
GTCTTCTCCTG -> TCTTCTCCTGT
CTGAATAACCA -> TGAATAACCAT
CAACTAATCAG -> AACTAATCAGC
GGTCGTCCAAG -> GTCGTCCAAGT
GAGGAGTTGAA -> AGGAGTTGAAC
GCCTATTTATT -> CCTATTTATTC
TGAGTTCACTC -> GAGTTCACTCA
CAGCGCTTAAC -> AGCGCTTAACA
ATTACACCCTG -> TTACACCCTGG
CTTGGCTTGCA -> TTGGCTTGCAA
CAGACAGTTAC -> AGACAGTTACT
TCCAAGTGTTG -> CCAAGTGTTGC
GTATATAGGTA -> TATATAGGTAG
CGACCCCTGAC -> GACCCCTGACC
AGCGTATGGAA -> GCGTATGGAAT
TCCTGGTCGTA -> CCTGGTCGTAA
GGTGTGTTTTA -> GTGTGTTTTAA
TTTAACTTTTG -> TTAACTTTTGC
GGTGTGAGTGG -> GTGTGAGTGGC
GCTATGTGACA -> CTATGTGACAG
AATGCTCTTTG -> ATGCTCTTTGT
TATGTGACAGT -> ATGTGACAGTT
TGCTCTTTGTT -> GCTCTTTGTTT
TCTAGGGAGGT -> CTAGGGAGGTC
GTGGGTGCTTT -> TGGGTGCTTTG
TAACGTGTGGG -> AACGTGTGGGA
GCGGTTTCAAC -> CGGTTTCAACA
TCTGTTATTGT -> CTGTTATTGTC
CAGAAGGATCA -> AGAAGGATCAC
TCCCCTCTCTA -> CCCCTCTCTAT
CTGCGCGGCTA -> TGCGCGGCTAA
TTGAATTTCAC -> TGAATTTCACT
TGGTGGTTAAC -> GGTGGTTAACC
CGGGTGGGCGA -> GGGTGGGCGAT
TCAGCCTTTCA -> CAGCCTTTCAG
AAGGCACCCGA -> AGGCACCCGAC
ATTCCACAACG -> TTCCACAACGC
CCCCGACTTAT -> CCCGACTTATG
CACAGCTCCAT -> ACAGCTCCATT
GGTAAAACGAT -> GTAAAACGATT
GTAAGCAGTCA -> TAAGCAGTCAA
GAGTGTACATC -> AGTGTACATCC
CATAACGTCTG -> ATAACGTCTGT
CGAAAGGTAAG -> GAAAGGTAAGC
TGCTTATAGCT -> GCTTATAGCTC
AACCCATGGAT -> ACCCATGGATC
AGCGCTTAACA -> GCGCTTAACAG
TTCTCGGGGTA -> TCTCGGGGTAA
GGATCTGTGAG -> GATCTGTGAGG
TAACGTCTGTG -> AACGTCTGTGG
CTTTGGCTCCG -> TTTGGCTCCGT
GATTGCAGCGT -> ATTGCAGCGTA
CGATCTATCGT -> GATCTATCGTG
CGGGGGAGCAC -> GGGGGAGCACA
TTTAGCCGTTA -> TTAGCCGTTAT
GATGAGCTAAC -> ATGAGCTAACA
TATTCAGCCTT -> ATTCAGCCTTT
CACTCGTGAGT -> ACTCGTGAGTT
AACAGTCGGAC -> ACAGTCGGACG
GAATTTATTAC -> AATTTATTACA
TGCGCGCTAAA -> GCGCGCTAAAA
GGGGTAAAACG -> GGGTAAAACGA
ACATCCGTTCT -> CATCCGTTCTA
TAATGTCTTTA -> AATGTCTTTAG
GGATGGGGTTT -> GATGGGGTTTA
TGTGAGTGGCG -> GTGAGTGGCGG
ATTCACGAAAG -> TTCACGAAAGA
AATCGCCTGGT -> ATCGCCTGGTT
GTACTGTATCA -> TACTGTATCAC
CGCTGGACATA -> GCTGGACATAA
TGTGAGTGTTT -> GTGAGTGTTTC
AACAGCGTAAT -> ACAGCGTAATC
GAAAAGATGAA -> AAAAGATGAAG
GTGTTGCTTAT -> TGTTGCTTATA
TTTGATGGGTA -> TTGATGGGTAT
GACATAAGGAT -> ACATAAGGATT
AGACCATATTC -> GACCATATTCG
GATCTATCGTG -> ATCTATCGTGG
TAATTTACTGC -> AATTTACTGCC
CCATGTTGGGC -> CATGTTGGGCA
ATACTACTCGG -> TACTACTCGGC
ATTAGTAGTCC -> TTAGTAGTCCG
ATTAATTTACT -> TTAATTTACTG
GAAGTTCTTAC -> AAGTTCTTACA
AGTTCACTCAA -> GTTCACTCAAG
GCGTGTCGAAA -> CGTGTCGAAAA
GGTATTCCTGG -> GTATTCCTGGT
TAATCGCCTGG -> AATCGCCTGGT
GGTCTCAGAGA -> GTCTCAGAGAA
CTCAATAGGGT -> TCAATAGGGTT
AGAGTTAGTTG -> GAGTTAGTTGG
CTCTCTATGTC -> TCTCTATGTCT
ATTTATTACAC -> TTTATTACACC
AGTTAGTTGGT -> GTTAGTTGGTG
TCTATGCCAGT -> CTATGCCAGTA
CATCCCTCTTT -> ATCCCTCTTTA
CACTAGAGCAA -> ACTAGAGCAAA
CACATATGTTG -> ACATATGTTGT
CTTCATGATCT -> TTCATGATCTG
ATATTCGCCTA -> TATTCGCCTAC
AACTGCGCGGC -> ACTGCGCGGCT
GTTATTCCACT -> TTATTCCACTG
TGCAAGGCATC -> GCAAGGCATCC
TATGGAGGTGG -> ATGGAGGTGGC
CAGTTACTCTA -> AGTTACTCTAG
TGCGCGGCTAA -> GCGCGGCTAAC
ATCTCCAAGGT -> TCTCCAAGGTG
CATTCCACAAC -> ATTCCACAACG
ATTGAATTCTG -> TTGAATTCTGA
CCTTTCAGAAG -> CTTTCAGAAGG
GGTTCACTAGA -> GTTCACTAGAG
TTTCAACATCA -> TTCAACATCAC
TTGCAGCGTAA -> TGCAGCGTAAC
ATAACCATGGT -> TAACCATGGTG
CCTATTCAGCC -> CTATTCAGCCT
ATGGTGGTTAA -> TGGTGGTTAAC
GTTGGAGGACG -> TTGGAGGACGT
GTACATCCGTT -> TACATCCGTTC
TAGTCCGGCTG -> AGTCCGGCTGT
TCGTCCAAGTG -> CGTCCAAGTGT
GAGCACAGGAG -> AGCACAGGAGG
TGGTTCCCCTC -> GGTTCCCCTCT
CTCGTTCTAGA -> TCGTTCTAGAA
GTAAGGGTCGT -> TAAGGGTCGTC
ATAGGTAGGTC -> TAGGTAGGTCT
TATGCGGTTTG -> ATGCGGTTTGC
TACGCACAGCT -> ACGCACAGCTC
GCCGTTATGTA -> CCGTTATGTAA
GGACGCTGTAT -> GACGCTGTATA
CTAGAAAATCC -> TAGAAAATCCC
GGCTCCGTCTT -> GCTCCGTCTTC
CTTTGTAACAG -> TTTGTAACAGA
TTTATTCTGCG -> TTATTCTGCGG
GTGCCATTTAT -> TGCCATTTATT
CCGTTATTCCA -> CGTTATTCCAC
TAGAGCAAACG -> AGAGCAAACGA
TACGCCCGGGT -> ACGCCCGGGTG
AGCGCGGTTTC -> GCGCGGTTTCA
GGAACTGCGCG -> GAACTGCGCGG
CATAGGTACTG -> ATAGGTACTGT
AGAAGTTCTTA -> GAAGTTCTTAC
GGATCTCGCGA -> GATCTCGCGAC
GCTTAACAGCG -> CTTAACAGCGT
GAATAACCATG -> AATAACCATGG
ACATAAGGATT -> CATAAGGATTA
GGCCATAATCT -> GCCATAATCTC
AGCTTAGACTG -> GCTTAGACTGG
TTATTCTGCGG -> TATTCTGCGGC
CTCGGGGTAAA -> TCGGGGTAAAA
TTTATTATGCG -> TTATTATGCGA
GATTTGCGATG -> ATTTGCGATGC
GATACCTCTGG -> ATACCTCTGGT
AACAAACCGGC -> ACAAACCGGCA
TTCCTGGTCGT -> TCCTGGTCGTA
CTGATGGGTCT -> TGATGGGTCTA
GAGAGGGCTTA -> AGAGGGCTTAG
GACCATATTCG -> ACCATATTCGC
TTCCTGGTCGA -> TCCTGGTCGAT
TATTCCACTGC -> ATTCCACTGCG
TACTACTCGGC -> ACTACTCGGCC
AACTTGAATTT -> ACTTGAATTTC
CGGGGCATAAA -> GGGGCATAAAA
ACAGTCGGACG -> CAGTCGGACGC
ACACATTCACC -> CACATTCACCA
CTATGTCTCCT -> TATGTCTCCTA
ACATTCACCAC -> CATTCACCACA
ACATGGGGCCG -> CATGGGGCCGG
GAGCAAACGAC -> AGCAAACGACT
CGTTACGCCCG -> GTTACGCCCGG
GTAATCGGAAT -> TAATCGGAATT
GTGCCTTCTCT -> TGCCTTCTCTT
GTTGGGCAACT -> TTGGGCAACTA
AGCCGTTATGT -> GCCGTTATGTA
CTGGATATGTT -> TGGATATGTTA
ATTCGATCTGG -> TTCGATCTGGG
TGTAAGGGTCG -> GTAAGGGTCGT
TCTGTGAGGTG -> CTGTGAGGTGC
CTATGGCGGGG -> TATGGCGGGGC
GGATTTGCGAT -> GATTTGCGATG
ATTCAGCCTTT -> TTCAGCCTTTC
TGTGACAGTTA -> GTGACAGTTAT
TTTCGAGACGC -> TTCGAGACGCG
CTCTATGTCTC -> TCTATGTCTCC
CTGACGAAAGG -> TGACGAAAGGT
GATACAGTTTT -> ATACAGTTTTA
ACAGAGAAGTT -> CAGAGAAGTTC
TGACCAAGGAT -> GACCAAGGATC
GAAGGCACCCG -> AAGGCACCCGA
ATTATTCTTTA -> TTATTCTTTAG
TAGGTGTGACC -> AGGTGTGACCT
CTGATCTGTTT -> TGATCTGTTTT
GATGATACCGT -> ATGATACCGTT
TCCTGTTGGGG -> CCTGTTGGGGT
GTGCTTTGACC -> TGCTTTGACCT
GCCCGGGTGGG -> CCCGGGTGGGC
TGCCATTTATT -> GCCATTTATTA
ACCTGAAGGCT -> CCTGAAGGCTG
GAGACGCGTTC -> AGACGCGTTCT
GTTTCGAGACG -> TTTCGAGACGC
TGGGCGATTCT -> GGGCGATTCTT
ATTTCTACTGG -> TTTCTACTGGA
CCCTCTCTATG -> CCTCTCTATGT
TCACGAAAGAC -> CACGAAAGACC
GGGAGCACAGG -> GGAGCACAGGA
CAACGCGTGTC -> AACGCGTGTCG
GGATCACCTCT -> GATCACCTCTC
TCGCCTGGTTC -> CGCCTGGTTCA
ACCCATGGATC -> CCCATGGATCT
ACCTCTCGATC -> CCTCTCGATCT
AAAAGGCTCAT -> AAAGGCTCATT
AGCAACTAATC -> GCAACTAATCA
CACTGCGGCTC -> ACTGCGGCTCC
CCATGGATCTC -> CATGGATCTCG
TATCAATTGAA -> ATCAATTGAAT
AAGACATCAGA -> AGACATCAGAC
AGAGACCGAAC -> GAGACCGAACG
GACGCGTTCTC -> ACGCGTTCTCG
CTATCGTGGTG -> TATCGTGGTGG
GAGACAATCCC -> AGACAATCCCC
GGTGGTAGTGG -> GTGGTAGTGGG
GGGTTCCTGGT -> GGTTCCTGGTC
CCCTGAGTCTA -> CCTGAGTCTAT
ACCTCTGGTAG -> CCTCTGGTAGA
AGAATAGAACT -> GAATAGAACTG
ATCTCTAGCGT -> TCTCTAGCGTA
TAAGTAGTGTC -> AAGTAGTGTCG
GGAGGGGGATT -> GAGGGGGATTT
ACCTTTGACAA -> CCTTTGACAAA
GAGGTGGCCAT -> AGGTGGCCATA
CTTGAATTTCA -> TTGAATTTCAC
CATTTCTACTG -> ATTTCTACTGG
ACCATGGTGGT -> CCATGGTGGTT
TCTGGGAACTT -> CTGGGAACTTT
CAGGGCTCGTG -> AGGGCTCGTGC
GTCGTCCAAGT -> TCGTCCAAGTG
CGCTCGTTCTA -> GCTCGTTCTAG
CTTTGACCTTT -> TTTGACCTTTG
CTTAACAGCGT -> TTAACAGCGTA
CAGCCCATGTT -> AGCCCATGTTG
AAGAACATTAA -> AGAACATTAAT
AAGGAGAGGGC -> AGGAGAGGGCT
GACAGTTATGG -> ACAGTTATGGT
GGACATAAGGA -> GACATAAGGAT
GGGTAAAACGA -> GGTAAAACGAT
CTAGGTGTGAC -> TAGGTGTGACC
GCTATCAACGC -> CTATCAACGCG
AGATGAAGGCA -> GATGAAGGCAC
TGAAGGCTGGA -> GAAGGCTGGAA
GGGGGATGTTA -> GGGGATGTTAG
TGGAGAAGCTT -> GGAGAAGCTTT
TATGTTGTCTT -> ATGTTGTCTTT
GGGCCGGGGAT -> GGCCGGGGATA
GCGTATGGAAT -> CGTATGGAATA
CGTGTCGAAAA -> GTGTCGAAAAG
CATTGTCTGAT -> ATTGTCTGATC
GATATGTTATG -> ATATGTTATGT
TGAGCTAACAA -> GAGCTAACAAA
GATTCTAACCC -> ATTCTAACCCG
GGGGATTCGGG -> GGGATTCGGGT
TTTGCATTCCG -> TTGCATTCCGT
CTGTTATTGTC -> TGTTATTGTCT
AGGAGGGAGAG -> GGAGGGAGAGT
AAATGCTCTTT -> AATGCTCTTTG
TCTATCCTGTA -> CTATCCTGTAG
TTATTCCACTG -> TATTCCACTGC
CGATACAGTTT -> GATACAGTTTT
TCGCGATTCTA -> CGCGATTCTAA
TCCGTTACTGG -> CCGTTACTGGT
AAAAGATGAAG -> AAAGATGAAGG
TTGTAACAGAG -> TGTAACAGAGA
AGGTCTTGGCT -> GGTCTTGGCTT
CAGTCGGACGC -> AGTCGGACGCG
TGACAGTTATG -> GACAGTTATGG
TTAGCGCGGAA -> TAGCGCGGAAG
ATTCCACTGCG -> TTCCACTGCGG
TCAATTGAATT -> CAATTGAATTC
AACCGGGAGAC -> ACCGGGAGACA
CTGGGAGAATT -> TGGGAGAATTT
AGACTGGATGG -> GACTGGATGGG
CCCGGGTGGGC -> CCGGGTGGGCG
CTATAAACTTG -> TATAAACTTGA
AACTAATCAGC -> ACTAATCAGCG
CCCGGCGTCCA -> CCGGCGTCCAC
TCCATTGTCTG -> CCATTGTCTGA
GGATTCCGGCG -> GATTCCGGCGG
GTTAGTTGGTG -> TTAGTTGGTGG
AGAGAAGTTCT -> GAGAAGTTCTT
TGATGATACCG -> GATGATACCGT
ACGTGTGGGAC -> CGTGTGGGACG
TAAGTGCCATT -> AAGTGCCATTT
ATTTTGATGGG -> TTTTGATGGGT
GGAATTTTCGG -> GAATTTTCGGA
ACGAAAGGTAA -> CGAAAGGTAAG
TGCATTCTCAA -> GCATTCTCAAT
ACGCACAGCTC -> CGCACAGCTCC
CTTTATGCGGT -> TTTATGCGGTT
ACACTAGAGGC -> CACTAGAGGCA
ATAGGGTTCCT -> TAGGGTTCCTG
TGGTTCACTAG -> GGTTCACTAGA
AGGGCGACGCT -> GGGCGACGCTG
TATTTATTCTG -> ATTTATTCTGC
AGAAAAGATGA -> GAAAAGATGAA
GTGACAGTTAT -> TGACAGTTATG
TCACTGGATAT -> CACTGGATATG
TGGGCAACTAT -> GGGCAACTATG
AAACCTGCCCC -> AACCTGCCCCT
TTTATGCGGTT -> TTATGCGGTTT
TCGGTGACATG -> CGGTGACATGA
GCATAACGTCT -> CATAACGTCTG
CGTGAGTTCAC -> GTGAGTTCACT
CCCCTCTCTAT -> CCCTCTCTATG
CCATTAGTAGT -> CATTAGTAGTC
TGAATTTCACT -> GAATTTCACTG
TAGGGCGACGC -> AGGGCGACGCT
AGGTCTCAGAG -> GGTCTCAGAGA
GAAGGAGAGGG -> AAGGAGAGGGC
TAACCATGGTG -> AACCATGGTGG
GGGGGAGCACA -> GGGGAGCACAG
TCGGAATTTTC -> CGGAATTTTCG
ACCGGGAGACA -> CCGGGAGACAA
GGGTGTGAGTG -> GGTGTGAGTGG
ATGAGTGCGTG -> TGAGTGCGTGG
AAGATGGTATG -> AGATGGTATGA
GTTTGCGCGCT -> TTTGCGCGCTA
TGACCAACATG -> GACCAACATGG
CTTCCGCTATC -> TTCCGCTATCA
GTTGGGGTTTT -> TTGGGGTTTTG
CTATCCTGTAG -> TATCCTGTAGG
CCCTGACCAAC -> CCTGACCAACA
GAGCTAACAAA -> AGCTAACAAAC
TGTTGTCTTTG -> GTTGTCTTTGT
TCTTTAGCCGT -> CTTTAGCCGTT
TGTACATCCGT -> GTACATCCGTT
CGGCTCCACAC -> GGCTCCACACT
GTTATGTAAGG -> TTATGTAAGGG
ATTTATTCTGC -> TTTATTCTGCG
CTAGCTTAGAC -> TAGCTTAGACT
GTGGCCATAAT -> TGGCCATAATC
ATCCCTCTTTA -> TCCCTCTTTAA
TCAAGATGAAG -> CAAGATGAAGG
GTGTTTTAACT -> TGTTTTAACTT
TATGACCAAGG -> ATGACCAAGGA
AATGTCTTTAG -> ATGTCTTTAGC
CTGGAACTGCG -> TGGAACTGCGC
CGACACCCCAT -> GACACCCCATT
GATTTTAAGTA -> ATTTTAAGTAG
GAGAGTTAGTT -> AGAGTTAGTTG
CACAACGCTAC -> ACAACGCTACC
CAGGAGGGAGA -> AGGAGGGAGAG
TGTTTTAACTT -> GTTTTAACTTT
GTGTTTCGAGA -> TGTTTCGAGAC
TTCCACAACGC -> TCCACAACGCT
CAGGAGGGGGA -> AGGAGGGGGAT
TGGATGGACTC -> GGATGGACTCC
ATGAAGGAGAG -> TGAAGGAGAGG
AATTGGATGAT -> ATTGGATGATT
GCGTAACAGTC -> CGTAACAGTCG
TGTAGGCCGTG -> GTAGGCCGTGT
CCTACTATGAC -> CTACTATGACC
ACCCCATTAGT -> CCCCATTAGTA
ATCTTTGGCTC -> TCTTTGGCTCC
TTGACAAACGC -> TGACAAACGCG
TCTTGATTATA -> CTTGATTATAA
CAAGCTACGCA -> AAGCTACGCAC
TAGGGTTCCTG -> AGGGTTCCTGG
TTTGTAACAGA -> TTGTAACAGAG
GACGTCAGCGT -> ACGTCAGCGTG
TAAAATGCTCT -> AAAATGCTCTT
CCACACTAGAG -> CACACTAGAGG
AGGGCTTAGCA -> GGGCTTAGCAA
GCTAACAAACC -> CTAACAAACCG
GGATTCGGGTG -> GATTCGGGTGT
CGGTTTGCGCG -> GGTTTGCGCGC
CTTGCTACGAT -> TTGCTACGATT
ATGAGTGGGGG -> TGAGTGGGGGA
GTGAGTTCACT -> TGAGTTCACTC
CTTTTGCATTC -> TTTTGCATTCC
TACCGACACCC -> ACCGACACCCC
GGGGCATAAAA -> GGGCATAAAAT
GAAAATCCCCA -> AAAATCCCCAT
TGGGGTTTAGC -> GGGGTTTAGCG
GGAGAAGCTTT -> GAGAAGCTTTA
GGGAGAGTTAG -> GGAGAGTTAGT
CTGACGGGGGA -> TGACGGGGGAG
TTCCATAGGTA -> TCCATAGGTAC
CGTAACAGTCG -> GTAACAGTCGG
AGAACTGACGA -> GAACTGACGAA
AAGGTAAGCAG -> AGGTAAGCAGT
AGGCTGGAACT -> GGCTGGAACTG
CGACTTGCTAC -> GACTTGCTACG
ATCGTGGTGGT -> TCGTGGTGGTA
AGGTGCAGCAG -> GGTGCAGCAGA
TCTATGGAGGT -> CTATGGAGGTG
TGGACTCCGCA -> GGACTCCGCAT
GAGGGAGAGTT -> AGGGAGAGTTA
GAGTGGGGGAT -> AGTGGGGGATT
TCTTCATGATC -> CTTCATGATCT
GGTCTAAGCGT -> GTCTAAGCGTG
CAATTGAATTC -> AATTGAATTCT
GGGTCTAAGCG -> GGTCTAAGCGT
TTTCACTGGAT -> TTCACTGGATA
GTAGATTCTAG -> TAGATTCTAGG
TTATTATGCGA -> TATTATGCGAG
CCTCTTTAAGA -> CTCTTTAAGAT
TCGCGACGATC -> CGCGACGATCT
TGTATCACCCG -> GTATCACCCGA
AGCTCCATTGT -> GCTCCATTGTC
AACCGGCAGCC -> ACCGGCAGCCC
CTCTGGTAGAT -> TCTGGTAGATT
TTGATGGGTAT -> TGATGGGTATT
CCGTTACTGGT -> CGTTACTGGTT
CAAGGCATCCC -> AAGGCATCCCT
CACCACAGGAG -> ACCACAGGAGG
CCAAGAACATT -> CAAGAACATTA
TAATCTATGGA -> AATCTATGGAG
AATTTTGATGG -> ATTTTGATGGG
TACTGGTTCCC -> ACTGGTTCCCC
GTAGTCCGGCT -> TAGTCCGGCTG
TGGTCTGATAC -> GGTCTGATACT
TGGAGGTGGCC -> GGAGGTGGCCA
CGTTATGTAAG -> GTTATGTAAGG
TAACCTAGCTT -> AACCTAGCTTA
ATTCTCAATAG -> TTCTCAATAGG
TCAGCGCTTAA -> CAGCGCTTAAC
GGTAGTGGGTG -> GTAGTGGGTGC
AGGAGTTGAAC -> GGAGTTGAACC
TCTTCTCCTGT -> CTTCTCCTGTT
GATCTGTTTTC -> ATCTGTTTTCA
GGATACGATAA -> GATACGATAAG
TCTATGTCTCC -> CTATGTCTCCT
ATGATACCGTT -> TGATACCGTTA
TAATCTCCAAG -> AATCTCCAAGG
AATAGGGTTCC -> ATAGGGTTCCT
TTGGAGGACGT -> TGGAGGACGTC
TACTGGATTCC -> ACTGGATTCCG
CCCGACACATT -> CCGACACATTC
CTTTCAGAAGG -> TTTCAGAAGGA
TAACAGTCGGA -> AACAGTCGGAC
CACTAGAGGCA -> ACTAGAGGCAT
TTCCGCTATCA -> TCCGCTATCAA
TAAATATCGCC -> AAATATCGCCT
AGGGAGAGTTA -> GGGAGAGTTAG
GTTCACTAGAG -> TTCACTAGAGC
CCCCTGACCAA -> CCCTGACCAAC
GCGTCCACTCG -> CGTCCACTCGT
GTAAACCGGGA -> TAAACCGGGAG
GTGCAGCAGAG -> TGCAGCAGAGC
CTATGACCAAG -> TATGACCAAGG
TGAGAATAATC -> GAGAATAATCT
TGTTATTGTCT -> GTTATTGTCTG
CCAAGCCCTGT -> CAAGCCCTGTC
CGTGTGAGTGT -> GTGTGAGTGTT
GCGTGATTTTA -> CGTGATTTTAA
TTATCGTGTCG -> TATCGTGTCGG
GGGTATTCCTG -> GGTATTCCTGG
TTACTGGTTCC -> TACTGGTTCCC
AATTTATTACA -> ATTTATTACAC
GGACGCGCACA -> GACGCGCACAC
ATTTATTATGC -> TTTATTATGCG
GCTACGCACAG -> CTACGCACAGC
GATTATAAATA -> ATTATAAATAT
CGTCTTCTCCT -> GTCTTCTCCTG
TCGCCTATTTA -> CGCCTATTTAT
TCCTGTAGGCC -> CCTGTAGGCCG
AGCGATACCTC -> GCGATACCTCT
GTTACGCCCGG -> TTACGCCCGGG
AGGACGTCAGC -> GGACGTCAGCG
TTGTCTTTGTA -> TGTCTTTGTAA
CGTTACTGGTT -> GTTACTGGTTC
ACACCCCATTA -> CACCCCATTAG
CTTATAGCTCC -> TTATAGCTCCT
TACGATTGCAG -> ACGATTGCAGC
CCGTTCTATCC -> CGTTCTATCCT
AGTCAAGCTAC -> GTCAAGCTACG
CTGATGATACC -> TGATGATACCG
GCGCTTAACAG -> CGCTTAACAGC
TGCGGTTTGCG -> GCGGTTTGCGC
GAACTGACGAA -> AACTGACGAAA
CGTGCTATGAG -> GTGCTATGAGT
GTAGTGGGTGC -> TAGTGGGTGCT
GAAAGACCATA -> AAAGACCATAT
GTGAGGTGCAG -> TGAGGTGCAGC
GGCTAACGTGT -> GCTAACGTGTG
GCTTCAGGGCT -> CTTCAGGGCTC
AAGGGTCGTCC -> AGGGTCGTCCA
GCGGCGACGCT -> CGGCGACGCTT
AACGCGTCTGG -> ACGCGTCTGGG
ATTCACCACAG -> TTCACCACAGG
CACCCGACACA -> ACCCGACACAT
CGATACCTCTG -> GATACCTCTGG
CGGCTAACGTG -> GGCTAACGTGT
ATGGTATGAGT -> TGGTATGAGTG
GTGGGACGCTG -> TGGGACGCTGT
GAGTTGAACCC -> AGTTGAACCCA
CTTCGGATGGG -> TTCGGATGGGG
CCTGTTGGGGT -> CTGTTGGGGTT
CGTGTGGGACG -> GTGTGGGACGC
TCCTGGTCGAT -> CCTGGTCGATA
TACCGTTGGAG -> ACCGTTGGAGG
ATGTAACAGAG -> TGTAACAGAGA
GGTAAGCAGTC -> GTAAGCAGTCA
CCATTCCACAA -> CATTCCACAAC
TCGTAAACCGG -> CGTAAACCGGG
TCTATCGTGGT -> CTATCGTGGTG
TGATTATAAAT -> GATTATAAATA
CGGATGGGGTT -> GGATGGGGTTT
AAGTAGTGTCG -> AGTAGTGTCGC
CGGGAGACAAT -> GGGAGACAATC
CCGTTATGTAA -> CGTTATGTAAG
TATAAACTTGA -> ATAAACTTGAA
GGCTCATTATC -> GCTCATTATCG
CCAGTATCAAT -> CAGTATCAATT
TCGAGACGCGT -> CGAGACGCGTT
CCGTCTTCTCC -> CGTCTTCTCCT
CGGGGTAAAAC -> GGGGTAAAACG
TGGCGGGGCAT -> GGCGGGGCATA
CGCTGTATATA -> GCTGTATATAG
CGATTCTAACC -> GATTCTAACCC
TTAATTTACTG -> TAATTTACTGC
TGAAGGAGAGG -> GAAGGAGAGGG
ATGTCTCCTAT -> TGTCTCCTATT
CCCATGTTGGG -> CCATGTTGGGC
TTCAAGTAATG -> TCAAGTAATGT
TGGCTTGCAAG -> GGCTTGCAAGG
ATCACATATGT -> TCACATATGTT
TTTGTTTAAGA -> TTGTTTAAGAC
TGGATATGTTA -> GGATATGTTAT
GGTAGGTCTCA -> GTAGGTCTCAG
ACACCCTGGCT -> CACCCTGGCTA
TACACAAAGAG -> ACACAAAGAGT
TCGCAGAAACC -> CGCAGAAACCT
TGGTAGATTCT -> GGTAGATTCTA
TTTGTAATCGG -> TTGTAATCGGA
TTTTCAAGTAA -> TTTCAAGTAAT
TCGGAGGAGTT -> CGGAGGAGTTG
GGTTCCTGGTC -> GTTCCTGGTCG
CTGGATGGGCC -> TGGATGGGCCA
AAGGATTAATT -> AGGATTAATTT
TTTGCGATGCA -> TTGCGATGCAT
ATCAACGCGTG -> TCAACGCGTGT
GGTGGCGTTAC -> GTGGCGTTACG
CGGCCAAGAAC -> GGCCAAGAACA
GGCCGTGTGAG -> GCCGTGTGAGT
TTCTAGGGAGG -> TCTAGGGAGGT
AAACGATTCGA -> AACGATTCGAT
AACCCGGCGTC -> ACCCGGCGTCC
TTCTCGTCTAG -> TCTCGTCTAGG
TACACCCTGGC -> ACACCCTGGCT
AAGGTGTGTTT -> AGGTGTGTTTT
GCGTGATGAGC -> CGTGATGAGCT
ATCACCCGACC -> TCACCCGACCC
AGATGAAGGAG -> GATGAAGGAGA
TCTACTGGATT -> CTACTGGATTC
CATTTATTATG -> ATTTATTATGC
TTCCCCTCTCT -> TCCCCTCTCTA
ATACCTCTGGT -> TACCTCTGGTA
CGACGCTTCAT -> GACGCTTCATT
GTGGCGTTACG -> TGGCGTTACGC
GGCTTCAGGGC -> GCTTCAGGGCT
TAGGCCGTGTG -> AGGCCGTGTGA
TTATTACACCC -> TATTACACCCT
CCATGGTGGTT -> CATGGTGGTTA
GCTTCATTTCT -> CTTCATTTCTA
CGGAATTTTCG -> GGAATTTTCGG
AAAGATGAAGG -> AAGATGAAGGA
TCTAGGTGTGA -> CTAGGTGTGAC
TCTGATCTGTT -> CTGATCTGTTT
ATTAATTTTGA -> TTAATTTTGAT
CTACCGTGTCT -> TACCGTGTCTT
CACCTCTCGAT -> ACCTCTCGATC
TGGGGGATTCG -> GGGGGATTCGG
CAAGGATCTGT -> AAGGATCTGTG
AACTGACGAAA -> ACTGACGAAAG
GATCTGGGAGA -> ATCTGGGAGAA
TAAGCGTGATG -> AAGCGTGATGA
AGGATCACCTC -> GGATCACCTCT
CGCACAGCTCC -> GCACAGCTCCA
CTCGCGACGAT -> TCGCGACGATC
ACTGCCTTCCG -> CTGCCTTCCGC
TTAACCTAGCT -> TAACCTAGCTT
AATCCCCATTC -> ATCCCCATTCC
TGTCTCCTATT -> GTCTCCTATTC
CAGTATCAATT -> AGTATCAATTG
TGTGGGCCGCT -> GTGGGCCGCTC
CCCTTCGGATG -> CCTTCGGATGG
ACGAAAGACCA -> CGAAAGACCAT
CGTAATCGCCT -> GTAATCGCCTG
GGGCCGCTCGT -> GGCCGCTCGTT
AGGCTCATTAT -> GGCTCATTATC
TTGAGAATAAT -> TGAGAATAATC
ATTGTCTGATC -> TTGTCTGATCT
CGACTTATGAT -> GACTTATGATT
TAGGGAGGTCT -> AGGGAGGTCTT
GCAGCGTAACA -> CAGCGTAACAG
TCTTTAAGATG -> CTTTAAGATGG
AGTGTCGCAGA -> GTGTCGCAGAA
GTGTGTTTTAA -> TGTGTTTTAAC
ATGTTATGTAA -> TGTTATGTAAC
GTGGTGGTAGT -> TGGTGGTAGTG
TGTTAACCTAG -> GTTAACCTAGC
TGGGTATTCCT -> GGGTATTCCTG
CGCCTACCGTG -> GCCTACCGTGT
TCTAGCGCGGT -> CTAGCGCGGTT
CCGCTCGTTCT -> CGCTCGTTCTA
CCGCTATCAAC -> CGCTATCAACG
CCAAGGTGTGT -> CAAGGTGTGTT
CGCTTAACAGC -> GCTTAACAGCG
TATTATTCTTT -> ATTATTCTTTA
GCACACGGTCT -> CACACGGTCTA
GGATTAATTTA -> GATTAATTTAC
GACACATTCAC -> ACACATTCACC
TGACCTTTGAC -> GACCTTTGACA
TAACTTTTGCA -> AACTTTTGCAT
GTAGTGTCGCA -> TAGTGTCGCAG
GGAGAATTTAT -> GAGAATTTATT
TCAGACAGTTA -> CAGACAGTTAC
ATTCCATAGGT -> TTCCATAGGTA
CTACGCACAGC -> TACGCACAGCT
CCAAGGATCTG -> CAAGGATCTGT
GAACTGCGCGG -> AACTGCGCGGC
TTGTCTGACGG -> TGTCTGACGGG
TGGCCATAATC -> GGCCATAATCT
TGACCTGAATA -> GACCTGAATAA
GCGTTCTCGTC -> CGTTCTCGTCT
GAATTTCACTG -> AATTTCACTGG
TTTAGCGATAC -> TTAGCGATACC
GGGGATGTTAG -> GGGATGTTAGA
TGCTATGAGTG -> GCTATGAGTGC
CTTTGTTTAAG -> TTTGTTTAAGA
CTGACCAACAT -> TGACCAACATG
ACCATATTCGC -> CCATATTCGCC
TCTGATGGGTC -> CTGATGGGTCT
CATGGATCTCG -> ATGGATCTCGC
TAGGACCCTTC -> AGGACCCTTCG
ACGCGCACACG -> CGCGCACACGG
GATGAAGGCAC -> ATGAAGGCACC
TCTGATACTAC -> CTGATACTACT
ACAAACCGGCA -> CAAACCGGCAG
TGTCTGATCTG -> GTCTGATCTGT
GATACCGACAC -> ATACCGACACC
GACCTGAATAA -> ACCTGAATAAC
CATATGTTGTC -> ATATGTTGTCT
CGTAAACCGGG -> GTAAACCGGGA
GATTCGATCTG -> ATTCGATCTGG
AGGTAGGTCTC -> GGTAGGTCTCA
AAGCCCTGTCT -> AGCCCTGTCTT
GGACTCCGCAT -> GACTCCGCATA
ACCAAGGATCT -> CCAAGGATCTG
ATCGTGTCGGT -> TCGTGTCGGTG
TTGGCTTGCAA -> TGGCTTGCAAG
AAGACCATATT -> AGACCATATTC
ATTCTAACCCG -> TTCTAACCCGG
TCCTACTATGA -> CCTACTATGAC
ATTTTAAGTAG -> TTTTAAGTAGT
TGCGATGCATT -> GCGATGCATTC
AGTTGGTGGCG -> GTTGGTGGCGT
AATTGAATTCT -> ATTGAATTCTG
GATACTACTCG -> ATACTACTCGG
GCTCCACACTA -> CTCCACACTAG
TATGTTATGTA -> ATGTTATGTAA
GATGAAGGAGA -> ATGAAGGAGAG
CAGCGTAACAG -> AGCGTAACAGT
TCAACATCACA -> CAACATCACAT
TGGTCGATACA -> GGTCGATACAG
CCTGAATAACC -> CTGAATAACCA
GGTCGTAAACC -> GTCGTAAACCG
TGTCTTCATGA -> GTCTTCATGAT
CTGAGTCTATG -> TGAGTCTATGC
AGTTATGGTCT -> GTTATGGTCTG
GTCTGATCTGT -> TCTGATCTGTT
TAGAACTGACG -> AGAACTGACGA
CATGGGGCCGG -> ATGGGGCCGGG
ATCTGTGAGGT -> TCTGTGAGGTG
ACTGGATATGT -> CTGGATATGTT
GAGTGCGTGGA -> AGTGCGTGGAG
TTACTGCCTTC -> TACTGCCTTCC
TTCTTTAGGGC -> TCTTTAGGGCG
TTAGCAACTAA -> TAGCAACTAAT
AGCGTAATCGC -> GCGTAATCGCC
CAACGCTACCG -> AACGCTACCGT
TGTTTAAGACA -> GTTTAAGACAT
GAGCATCTCTA -> AGCATCTCTAG
TTCTCCTGTTG -> TCTCCTGTTGG
TAAACCGGGAG -> AAACCGGGAGA
ACCTGCCCCTG -> CCTGCCCCTGA
CCGACACATTC -> CGACACATTCA
CCCCTGAGTCT -> CCCTGAGTCTA
ACATTAATTTT -> CATTAATTTTG
TCAATAGGGTT -> CAATAGGGTTC
TGTCGAAAAGG -> GTCGAAAAGGC
ATGGAATAGGA -> TGGAATAGGAC
GTCGCAGAAAC -> TCGCAGAAACC
TTGGTGGCGTT -> TGGTGGCGTTA
GCAACTATGGC -> CAACTATGGCG
TTAGTAGTCCG -> TAGTAGTCCGG
CAGTTATGGTC -> AGTTATGGTCT
AGAGAATAGAA -> GAGAATAGAAC
GCACCCGACAC -> CACCCGACACA
GCGTAATCGCC -> CGTAATCGCCT
CTTAGCAACTA -> TTAGCAACTAA
GAACGTACATT -> AACGTACATTC
CTGCGGCGACG -> TGCGGCGACGC
GGCTCCACACT -> GCTCCACACTA
AACAGAGAAGT -> ACAGAGAAGTT
GTGAGTGGCGG -> TGAGTGGCGGG
GATGATTCTCG -> ATGATTCTCGG
GGGGATACGAT -> GGGATACGATA
CTCTCGATCTT -> TCTCGATCTTT
TTACTCTAGCG -> TACTCTAGCGC
GCGCACACGGT -> CGCACACGGTC
GAACCCATGGA -> AACCCATGGAT
GTCTAAGCGTG -> TCTAAGCGTGA
TGATGGGTCTA -> GATGGGTCTAA
AAACCGGCAGC -> AACCGGCAGCC
CCATAGGTACT -> CATAGGTACTG
CTTATGATTTG -> TTATGATTTGT
CGTGATTTTAA -> GTGATTTTAAG
CTGTCTGATGA -> TGTCTGATGAT
TAATCAGCGCT -> AATCAGCGCTT
AAGTGCCATTT -> AGTGCCATTTA
TTGCAAGGCAT -> TGCAAGGCATC
CCTGCCCCTGA -> CTGCCCCTGAG
CTTCAGGGCTC -> TTCAGGGCTCG
ACTGCGGCTCC -> CTGCGGCTCCA
ATACAGTTTTA -> TACAGTTTTAG
GCATTCCATAG -> CATTCCATAGG
GCTTAGCAACT -> CTTAGCAACTA
CATCTCTAGCG -> ATCTCTAGCGT
CTCGTGCTATG -> TCGTGCTATGA
CCCTCTTTAAG -> CCTCTTTAAGA
CGGCGGGGGAT -> GGCGGGGGATG
TGATTTTAAGT -> GATTTTAAGTA
TTCTACTGGAT -> TCTACTGGATT
TCCGGCTGTTA -> CCGGCTGTTAA
TTTTAGCGATA -> TTTAGCGATAC
AAGTTCTTACA -> AGTTCTTACAC
ACCGTGTCTTC -> CCGTGTCTTCA
TCTCAATAGGG -> CTCAATAGGGT
AGACAATCCCC -> GACAATCCCCC
TCTCGCGACGA -> CTCGCGACGAT
TTATTCTTTAG -> TATTCTTTAGG
AGCCTTTCAGA -> GCCTTTCAGAA
CTGCCCCTGAG -> TGCCCCTGAGT
ACGTCTGTGGG -> CGTCTGTGGGC
TTAGCCGTTAT -> TAGCCGTTATG
AGAGGGCTTAG -> GAGGGCTTAGC
GATGTTAGAGA -> ATGTTAGAGAC
CATTCTCAATA -> ATTCTCAATAG
TGGCGGGTGCC -> GGCGGGTGCCT
TTATGCGAGGT -> TATGCGAGGTG
